name,winner,gender,birthYear,year_film,category,ceremonyAge,num_times_nominated
Abigail Breslin,False,F,1996,2006,ACTRESS IN A SUPPORTING ROLE,10,1
Adam Driver,False,M,1983,2018,ACTOR IN A SUPPORTING ROLE,35,2
Adam Driver,False,M,1983,2019,ACTOR IN A LEADING ROLE,36,2
Adolph Caesar,False,M,1933,1984,ACTOR IN A SUPPORTING ROLE,51,1
Adolphe Menjou,False,M,1890,1930,ACTOR,40,1
Adriana Barraza,False,F,1956,2006,ACTRESS IN A SUPPORTING ROLE,50,1
Adrien Brody,True,M,1973,2002,ACTOR IN A LEADING ROLE,29,1
Agnes Moorehead,False,F,1900,1942,ACTRESS IN A SUPPORTING ROLE,42,4
Agnes Moorehead,False,F,1900,1944,ACTRESS IN A SUPPORTING ROLE,44,4
Agnes Moorehead,False,F,1900,1948,ACTRESS IN A SUPPORTING ROLE,48,4
Agnes Moorehead,False,F,1900,1964,ACTRESS IN A SUPPORTING ROLE,64,4
Akim Tamiroff,False,M,1899,1936,ACTOR IN A SUPPORTING ROLE,37,2
Akim Tamiroff,False,M,1899,1943,ACTOR IN A SUPPORTING ROLE,44,2
Al Pacino,False,M,1940,1972,ACTOR IN A SUPPORTING ROLE,32,9
Al Pacino,False,M,1940,1973,ACTOR,33,9
Al Pacino,False,M,1940,1974,ACTOR,34,9
Al Pacino,False,M,1940,1975,ACTOR,35,9
Al Pacino,False,M,1940,1979,ACTOR IN A LEADING ROLE,39,9
Al Pacino,False,M,1940,1990,ACTOR IN A SUPPORTING ROLE,50,9
Al Pacino,False,M,1940,1992,ACTOR IN A SUPPORTING ROLE,52,9
Al Pacino,False,M,1940,2019,ACTOR IN A SUPPORTING ROLE,79,9
Al Pacino,True,M,1940,1992,ACTOR IN A LEADING ROLE,52,9
Alan Alda,False,M,1936,2004,ACTOR IN A SUPPORTING ROLE,68,1
Alan Arkin,False,M,1934,1966,ACTOR,32,4
Alan Arkin,False,M,1934,1968,ACTOR,34,4
Alan Arkin,False,M,1934,2012,ACTOR IN A SUPPORTING ROLE,78,4
Alan Arkin,True,M,1934,2006,ACTOR IN A SUPPORTING ROLE,72,4
Alan Bates,False,M,1934,1968,ACTOR,34,1
Albert Brooks,False,M,1947,1987,ACTOR IN A SUPPORTING ROLE,40,1
Albert Finney,False,M,1936,1963,ACTOR,27,5
Albert Finney,False,M,1936,1974,ACTOR,38,5
Albert Finney,False,M,1936,1983,ACTOR IN A LEADING ROLE,47,5
Albert Finney,False,M,1936,1984,ACTOR IN A LEADING ROLE,48,5
Albert Finney,False,M,1936,2000,ACTOR IN A SUPPORTING ROLE,64,5
Alec Baldwin,False,M,1958,2003,ACTOR IN A SUPPORTING ROLE,45,1
Alec Guinness,False,M,1914,1952,ACTOR,38,4
Alec Guinness,False,M,1914,1977,ACTOR IN A SUPPORTING ROLE,63,4
Alec Guinness,False,M,1914,1988,ACTOR IN A SUPPORTING ROLE,74,4
Alec Guinness,True,M,1914,1957,ACTOR,43,4
Alexander Knox,False,M,1907,1944,ACTOR,37,1
Alfre Woodard,False,F,1952,1983,ACTRESS IN A SUPPORTING ROLE,31,1
Alfred Lunt,False,M,1892,1931,ACTOR,39,1
Ali MacGraw,False,F,1939,1970,ACTRESS,31,1
Alice Brady,False,F,1892,1936,ACTRESS IN A SUPPORTING ROLE,44,2
Alice Brady,True,F,1892,1937,ACTRESS IN A SUPPORTING ROLE,45,2
Alicia Vikander,True,F,1988,2015,ACTRESS IN A SUPPORTING ROLE,27,1
Aline MacMahon,False,F,1899,1944,ACTRESS IN A SUPPORTING ROLE,45,1
Allison Janney,True,F,1959,2017,ACTRESS IN A SUPPORTING ROLE,58,1
Amy Adams,False,F,1974,2005,ACTRESS IN A SUPPORTING ROLE,31,6
Amy Adams,False,F,1974,2008,ACTRESS IN A SUPPORTING ROLE,34,6
Amy Adams,False,F,1974,2010,ACTRESS IN A SUPPORTING ROLE,36,6
Amy Adams,False,F,1974,2012,ACTRESS IN A SUPPORTING ROLE,38,6
Amy Adams,False,F,1974,2013,ACTRESS IN A LEADING ROLE,39,6
Amy Adams,False,F,1974,2018,ACTRESS IN A SUPPORTING ROLE,44,6
Amy Irving,False,F,1953,1983,ACTRESS IN A SUPPORTING ROLE,30,1
Amy Madigan,False,F,1950,1985,ACTRESS IN A SUPPORTING ROLE,35,1
Amy Ryan,False,F,1968,2007,ACTRESS IN A SUPPORTING ROLE,39,1
Andrea Leeds,False,F,1914,1937,ACTRESS IN A SUPPORTING ROLE,23,1
Andrew Garfield,False,M,1983,2016,ACTOR IN A LEADING ROLE,33,1
Andy Garcia,False,M,1956,1990,ACTOR IN A SUPPORTING ROLE,34,1
Angela Bassett,False,F,1958,1993,ACTRESS IN A LEADING ROLE,35,1
Angela Lansbury,False,F,1925,1944,ACTRESS IN A SUPPORTING ROLE,19,3
Angela Lansbury,False,F,1925,1945,ACTRESS IN A SUPPORTING ROLE,20,3
Angela Lansbury,False,F,1925,1962,ACTRESS IN A SUPPORTING ROLE,37,3
Angelina Jolie,False,F,1975,2008,ACTRESS IN A LEADING ROLE,33,2
Angelina Jolie,True,F,1975,1999,ACTRESS IN A SUPPORTING ROLE,24,2
Anjelica Huston,False,F,1951,1989,ACTRESS IN A SUPPORTING ROLE,38,3
Anjelica Huston,False,F,1951,1990,ACTRESS IN A LEADING ROLE,39,3
Anjelica Huston,True,F,1951,1985,ACTRESS IN A SUPPORTING ROLE,34,3
Ann Blyth,False,F,1927,1945,ACTRESS IN A SUPPORTING ROLE,18,1
Ann Harding,False,F,1902,1930,ACTRESS,28,1
Ann Sothern,False,F,1909,1987,ACTRESS IN A SUPPORTING ROLE,78,1
Ann-Margret,False,F,1941,1971,ACTRESS IN A SUPPORTING ROLE,30,2
Ann-Margret,False,F,1941,1975,ACTRESS,34,2
Anna Kendrick,False,F,1985,2009,ACTRESS IN A SUPPORTING ROLE,24,1
Anna Magnani,False,F,1908,1957,ACTRESS,49,2
Anna Magnani,True,F,1908,1955,ACTRESS,47,2
Anna Paquin,True,F,1982,1993,ACTRESS IN A SUPPORTING ROLE,11,1
Anne Archer,False,F,1947,1987,ACTRESS IN A SUPPORTING ROLE,40,1
Anne Bancroft,False,F,1931,1964,ACTRESS,33,5
Anne Bancroft,False,F,1931,1967,ACTRESS,36,5
Anne Bancroft,False,F,1931,1977,ACTRESS IN A LEADING ROLE,46,5
Anne Bancroft,False,F,1931,1985,ACTRESS IN A LEADING ROLE,54,5
Anne Bancroft,True,F,1931,1962,ACTRESS,31,5
Anne Baxter,False,F,1923,1950,ACTRESS,27,2
Anne Baxter,True,F,1923,1946,ACTRESS IN A SUPPORTING ROLE,23,2
Anne Hathaway,False,F,1982,2008,ACTRESS IN A LEADING ROLE,26,2
Anne Hathaway,True,F,1982,2012,ACTRESS IN A SUPPORTING ROLE,30,2
Anne Ramsey,False,F,1929,1987,ACTRESS IN A SUPPORTING ROLE,58,1
Anne Revere,False,F,1903,1943,ACTRESS IN A SUPPORTING ROLE,40,3
Anne Revere,False,F,1903,1947,ACTRESS IN A SUPPORTING ROLE,44,3
Anne Revere,True,F,1903,1945,ACTRESS IN A SUPPORTING ROLE,42,3
Anne Shirley,False,F,1918,1937,ACTRESS IN A SUPPORTING ROLE,19,1
Annette Bening,False,F,1958,1990,ACTRESS IN A SUPPORTING ROLE,32,4
Annette Bening,False,F,1958,1999,ACTRESS IN A LEADING ROLE,41,4
Annette Bening,False,F,1958,2004,ACTRESS IN A LEADING ROLE,46,4
Annette Bening,False,F,1958,2010,ACTRESS IN A LEADING ROLE,52,4
Anthony Franciosa,False,M,1928,1957,ACTOR,29,1
Anthony Hopkins,False,M,1937,1993,ACTOR IN A LEADING ROLE,56,5
Anthony Hopkins,False,M,1937,1995,ACTOR IN A LEADING ROLE,58,5
Anthony Hopkins,False,M,1937,1997,ACTOR IN A SUPPORTING ROLE,60,5
Anthony Hopkins,False,M,1937,2019,ACTOR IN A SUPPORTING ROLE,82,5
Anthony Hopkins,True,M,1937,1991,ACTOR IN A LEADING ROLE,54,5
Anthony Perkins,False,M,1932,1956,ACTOR IN A SUPPORTING ROLE,24,1
Anthony Quayle,False,M,1913,1969,ACTOR IN A SUPPORTING ROLE,56,1
Anthony Quinn,False,M,1915,1957,ACTOR,42,4
Anthony Quinn,False,M,1915,1964,ACTOR,49,4
Anthony Quinn,True,M,1915,1952,ACTOR IN A SUPPORTING ROLE,37,4
Anthony Quinn,True,M,1915,1956,ACTOR IN A SUPPORTING ROLE,41,4
Antonio Banderas,False,M,1960,2019,ACTOR IN A LEADING ROLE,59,1
Armin Mueller-Stahl,False,M,1930,1996,ACTOR IN A SUPPORTING ROLE,66,1
Art Carney,True,M,1918,1974,ACTOR,56,1
Arthur Hunnicutt,False,M,1910,1952,ACTOR IN A SUPPORTING ROLE,42,1
Arthur Kennedy,False,M,1914,1949,ACTOR IN A SUPPORTING ROLE,35,5
Arthur Kennedy,False,M,1914,1951,ACTOR,37,5
Arthur Kennedy,False,M,1914,1955,ACTOR IN A SUPPORTING ROLE,41,5
Arthur Kennedy,False,M,1914,1957,ACTOR IN A SUPPORTING ROLE,43,5
Arthur Kennedy,False,M,1914,1958,ACTOR IN A SUPPORTING ROLE,44,5
Arthur O'Connell,False,M,1908,1955,ACTOR IN A SUPPORTING ROLE,47,2
Arthur O'Connell,False,M,1908,1959,ACTOR IN A SUPPORTING ROLE,51,2
Audrey Hepburn,False,F,1929,1954,ACTRESS,25,5
Audrey Hepburn,False,F,1929,1959,ACTRESS,30,5
Audrey Hepburn,False,F,1929,1961,ACTRESS,32,5
Audrey Hepburn,False,F,1929,1967,ACTRESS,38,5
Audrey Hepburn,True,F,1929,1953,ACTRESS,24,5
Ava Gardner,False,F,1922,1953,ACTRESS,31,1
Barbara Barrie,False,F,1931,1979,ACTRESS IN A SUPPORTING ROLE,48,1
Barbara Bel Geddes,False,F,1922,1948,ACTRESS IN A SUPPORTING ROLE,26,1
Barbara Harris,False,F,1935,1971,ACTRESS IN A SUPPORTING ROLE,36,1
Barbara Hershey,False,F,1948,1996,ACTRESS IN A SUPPORTING ROLE,48,1
Barbara O'Neil,False,F,1910,1940,ACTRESS IN A SUPPORTING ROLE,30,1
Barbara Stanwyck,False,F,1907,1937,ACTRESS,30,4
Barbara Stanwyck,False,F,1907,1941,ACTRESS,34,4
Barbara Stanwyck,False,F,1907,1944,ACTRESS,37,4
Barbara Stanwyck,False,F,1907,1948,ACTRESS,41,4
Barbra Streisand,False,F,1942,1973,ACTRESS,31,2
Barbra Streisand,True,F,1942,1968,ACTRESS,26,2
Barkhad Abdi,False,M,1985,2013,ACTOR IN A SUPPORTING ROLE,28,1
Barry Fitzgerald,False,M,1888,1944,ACTOR,56,2
Barry Fitzgerald,True,M,1888,1944,ACTOR IN A SUPPORTING ROLE,56,2
Basil Rathbone,False,M,1892,1936,ACTOR IN A SUPPORTING ROLE,44,2
Basil Rathbone,False,M,1892,1938,ACTOR IN A SUPPORTING ROLE,46,2
Beah Richards,False,F,1920,1967,ACTRESS IN A SUPPORTING ROLE,47,1
Beatrice Straight,True,F,1914,1976,ACTRESS IN A SUPPORTING ROLE,62,1
Ben Johnson,True,M,1918,1971,ACTOR IN A SUPPORTING ROLE,53,1
Ben Kingsley,False,M,1943,1991,ACTOR IN A SUPPORTING ROLE,48,4
Ben Kingsley,False,M,1943,2001,ACTOR IN A SUPPORTING ROLE,58,4
Ben Kingsley,False,M,1943,2003,ACTOR IN A LEADING ROLE,60,4
Ben Kingsley,True,M,1943,1982,ACTOR IN A LEADING ROLE,39,4
Benedict Cumberbatch,False,M,1976,2014,ACTOR IN A LEADING ROLE,38,1
Benicio Del Toro,False,M,1967,2003,ACTOR IN A SUPPORTING ROLE,36,2
Benicio Del Toro,True,M,1967,2000,ACTOR IN A SUPPORTING ROLE,33,2
Bessie Love,False,F,1898,1928,ACTRESS,30,1
Betsy Blair,False,F,1923,1955,ACTRESS IN A SUPPORTING ROLE,32,1
Bette Davis,False,F,1908,1934,ACTRESS,26,11
Bette Davis,False,F,1908,1939,ACTRESS,31,11
Bette Davis,False,F,1908,1940,ACTRESS,32,11
Bette Davis,False,F,1908,1941,ACTRESS,33,11
Bette Davis,False,F,1908,1942,ACTRESS,34,11
Bette Davis,False,F,1908,1944,ACTRESS,36,11
Bette Davis,False,F,1908,1950,ACTRESS,42,11
Bette Davis,False,F,1908,1952,ACTRESS,44,11
Bette Davis,False,F,1908,1962,ACTRESS,54,11
Bette Davis,True,F,1908,1935,ACTRESS,27,11
Bette Davis,True,F,1908,1938,ACTRESS,30,11
Bette Midler,False,F,1945,1979,ACTRESS IN A LEADING ROLE,34,2
Bette Midler,False,F,1945,1991,ACTRESS IN A LEADING ROLE,46,2
Betty Compson,False,F,1897,1928,ACTRESS,31,1
Beulah Bondi,False,F,1889,1936,ACTRESS IN A SUPPORTING ROLE,47,2
Beulah Bondi,False,F,1889,1938,ACTRESS IN A SUPPORTING ROLE,49,2
Bill Murray,False,M,1950,2003,ACTOR IN A LEADING ROLE,53,1
Billie Burke,False,F,1884,1938,ACTRESS IN A SUPPORTING ROLE,54,1
Billy Bob Thornton,False,M,1955,1996,ACTOR IN A LEADING ROLE,41,2
Billy Bob Thornton,False,M,1955,1998,ACTOR IN A SUPPORTING ROLE,43,2
Bing Crosby,False,M,1903,1945,ACTOR,42,3
Bing Crosby,False,M,1903,1954,ACTOR,51,3
Bing Crosby,True,M,1903,1944,ACTOR,41,3
Bob Hoskins,False,M,1942,1986,ACTOR IN A LEADING ROLE,44,1
Bobby Darin,False,M,1936,1963,ACTOR IN A SUPPORTING ROLE,27,1
Bonita Granville,False,F,1923,1936,ACTRESS IN A SUPPORTING ROLE,13,1
Brad Dourif,False,M,1950,1975,ACTOR IN A SUPPORTING ROLE,25,1
Brad Pitt,False,M,1963,1995,ACTOR IN A SUPPORTING ROLE,32,4
Brad Pitt,False,M,1963,2008,ACTOR IN A LEADING ROLE,45,4
Brad Pitt,False,M,1963,2011,ACTOR IN A LEADING ROLE,48,4
Brad Pitt,True,M,1963,2019,ACTOR IN A SUPPORTING ROLE,56,4
Bradley Cooper,False,M,1975,2012,ACTOR IN A LEADING ROLE,37,4
Bradley Cooper,False,M,1975,2013,ACTOR IN A SUPPORTING ROLE,38,4
Bradley Cooper,False,M,1975,2014,ACTOR IN A LEADING ROLE,39,4
Bradley Cooper,False,M,1975,2018,ACTOR IN A LEADING ROLE,43,4
Brandon De Wilde,False,M,1942,1953,ACTOR IN A SUPPORTING ROLE,11,1
Brenda Blethyn,False,F,1946,1996,ACTRESS IN A LEADING ROLE,50,2
Brenda Blethyn,False,F,1946,1998,ACTRESS IN A SUPPORTING ROLE,52,2
Brenda Fricker,True,F,1945,1989,ACTRESS IN A SUPPORTING ROLE,44,1
Brenda Vaccaro,False,F,1939,1975,ACTRESS IN A SUPPORTING ROLE,36,1
Brian Aherne,False,M,1902,1939,ACTOR IN A SUPPORTING ROLE,37,1
Brian Donlevy,False,M,1901,1939,ACTOR IN A SUPPORTING ROLE,38,1
Brie Larson,True,F,1989,2015,ACTRESS IN A LEADING ROLE,26,1
Broderick Crawford,True,M,1911,1949,ACTOR,38,1
Bruce Davison,False,M,1946,1990,ACTOR IN A SUPPORTING ROLE,44,1
Bruce Dern,False,M,1936,1978,ACTOR IN A SUPPORTING ROLE,42,2
Bruce Dern,False,M,1936,2013,ACTOR IN A LEADING ROLE,77,2
Bryan Cranston,False,M,1956,2015,ACTOR IN A LEADING ROLE,59,1
Burgess Meredith,False,M,1907,1975,ACTOR IN A SUPPORTING ROLE,68,2
Burgess Meredith,False,M,1907,1976,ACTOR IN A SUPPORTING ROLE,69,2
Burl Ives,True,M,1909,1958,ACTOR IN A SUPPORTING ROLE,49,1
Burt Lancaster,False,M,1913,1953,ACTOR,40,4
Burt Lancaster,False,M,1913,1962,ACTOR,49,4
Burt Lancaster,False,M,1913,1981,ACTOR IN A LEADING ROLE,68,4
Burt Lancaster,True,M,1913,1960,ACTOR,47,4
Burt Reynolds,False,M,1936,1997,ACTOR IN A SUPPORTING ROLE,61,1
Burt Young,False,M,1940,1976,ACTOR IN A SUPPORTING ROLE,36,1
Bérénice Bejo,False,F,1976,2011,ACTRESS IN A SUPPORTING ROLE,35,1
Candice Bergen,False,F,1946,1979,ACTRESS IN A SUPPORTING ROLE,33,1
Candy Clark,False,F,1947,1973,ACTRESS IN A SUPPORTING ROLE,26,1
Cara Williams,False,F,1925,1958,ACTRESS IN A SUPPORTING ROLE,33,1
Carey Mulligan,False,F,1985,2009,ACTRESS IN A LEADING ROLE,24,1
Carol Channing,False,F,1921,1967,ACTRESS IN A SUPPORTING ROLE,46,1
Carol Kane,False,F,1952,1975,ACTRESS,23,1
Carole Lombard,False,F,1908,1936,ACTRESS,28,1
Carolyn Jones,False,F,1930,1957,ACTRESS IN A SUPPORTING ROLE,27,1
Carrie Snodgress,False,F,1945,1970,ACTRESS,25,1
Carroll Baker,False,F,1931,1956,ACTRESS,25,1
Cary Grant,False,M,1904,1941,ACTOR,37,2
Cary Grant,False,M,1904,1944,ACTOR,40,2
Casey Affleck,False,M,1975,2007,ACTOR IN A SUPPORTING ROLE,32,2
Casey Affleck,True,M,1975,2016,ACTOR IN A LEADING ROLE,41,2
Catalina Sandino Moreno,False,F,1981,2004,ACTRESS IN A LEADING ROLE,23,1
Cate Blanchett,False,F,1969,1998,ACTRESS IN A LEADING ROLE,29,7
Cate Blanchett,False,F,1969,2006,ACTRESS IN A SUPPORTING ROLE,37,7
Cate Blanchett,False,F,1969,2007,ACTRESS IN A LEADING ROLE,38,7
Cate Blanchett,False,F,1969,2007,ACTRESS IN A SUPPORTING ROLE,38,7
Cate Blanchett,False,F,1969,2015,ACTRESS IN A LEADING ROLE,46,7
Cate Blanchett,True,F,1969,2004,ACTRESS IN A SUPPORTING ROLE,35,7
Cate Blanchett,True,F,1969,2013,ACTRESS IN A LEADING ROLE,44,7
Catherine Burns,False,F,1945,1969,ACTRESS IN A SUPPORTING ROLE,24,1
Catherine Deneuve,False,F,1943,1992,ACTRESS IN A LEADING ROLE,49,1
Catherine Keener,False,F,1959,1999,ACTRESS IN A SUPPORTING ROLE,40,2
Catherine Keener,False,F,1959,2005,ACTRESS IN A SUPPORTING ROLE,46,2
Catherine Zeta-Jones,True,F,1969,2002,ACTRESS IN A SUPPORTING ROLE,33,1
Cathy Moriarty,False,F,1960,1980,ACTRESS IN A SUPPORTING ROLE,20,1
Cecil Kellaway,False,M,1890,1948,ACTOR IN A SUPPORTING ROLE,58,2
Cecil Kellaway,False,M,1890,1967,ACTOR IN A SUPPORTING ROLE,77,2
Celeste Holm,False,F,1917,1949,ACTRESS IN A SUPPORTING ROLE,32,3
Celeste Holm,False,F,1917,1950,ACTRESS IN A SUPPORTING ROLE,33,3
Celeste Holm,True,F,1917,1947,ACTRESS IN A SUPPORTING ROLE,30,3
Celia Johnson,False,F,1908,1946,ACTRESS,38,1
Charles Bickford,False,M,1891,1943,ACTOR IN A SUPPORTING ROLE,52,3
Charles Bickford,False,M,1891,1947,ACTOR IN A SUPPORTING ROLE,56,3
Charles Bickford,False,M,1891,1948,ACTOR IN A SUPPORTING ROLE,57,3
Charles Boyer,False,M,1899,1937,ACTOR,38,4
Charles Boyer,False,M,1899,1938,ACTOR,39,4
Charles Boyer,False,M,1899,1944,ACTOR,45,4
Charles Boyer,False,M,1899,1961,ACTOR,62,4
Charles Chaplin,False,M,1889,1940,ACTOR,51,1
Charles Coburn,False,M,1877,1941,ACTOR IN A SUPPORTING ROLE,64,3
Charles Coburn,False,M,1877,1946,ACTOR IN A SUPPORTING ROLE,69,3
Charles Coburn,True,M,1877,1943,ACTOR IN A SUPPORTING ROLE,66,3
Charles Durning,False,M,1923,1982,ACTOR IN A SUPPORTING ROLE,59,2
Charles Durning,False,M,1923,1983,ACTOR IN A SUPPORTING ROLE,60,2
Charles Laughton,False,M,1899,1935,ACTOR,36,3
Charles Laughton,False,M,1899,1957,ACTOR,58,3
Charles Laughton,True,M,1899,1932,ACTOR,33,3
Charlize Theron,False,F,1975,2005,ACTRESS IN A LEADING ROLE,30,3
Charlize Theron,False,F,1975,2019,ACTRESS IN A LEADING ROLE,44,3
Charlize Theron,True,F,1975,2003,ACTRESS IN A LEADING ROLE,28,3
Charlotte Rampling,False,F,1946,2015,ACTRESS IN A LEADING ROLE,69,1
Charlton Heston,True,M,1923,1959,ACTOR,36,1
Chazz Palminteri,False,M,1952,1994,ACTOR IN A SUPPORTING ROLE,42,1
Cher,False,F,1946,1983,ACTRESS IN A SUPPORTING ROLE,37,2
Cher,True,F,1946,1987,ACTRESS IN A LEADING ROLE,41,2
Chester Morris,False,M,1901,1928,ACTOR,27,1
Chief Dan George,False,M,1899,1970,ACTOR IN A SUPPORTING ROLE,71,1
Chill Wills,False,M,1902,1960,ACTOR IN A SUPPORTING ROLE,58,1
Chiwetel Ejiofor,False,M,1977,2013,ACTOR IN A LEADING ROLE,36,1
Chloë Sevigny,False,F,1974,1999,ACTRESS IN A SUPPORTING ROLE,25,1
Chris Cooper,True,M,1951,2002,ACTOR IN A SUPPORTING ROLE,51,1
Chris Sarandon,False,M,1942,1975,ACTOR IN A SUPPORTING ROLE,33,1
Christian Bale,False,M,1974,2013,ACTOR IN A LEADING ROLE,39,4
Christian Bale,False,M,1974,2015,ACTOR IN A SUPPORTING ROLE,41,4
Christian Bale,False,M,1974,2018,ACTOR IN A LEADING ROLE,44,4
Christian Bale,True,M,1974,2010,ACTOR IN A SUPPORTING ROLE,36,4
Christine Lahti,False,F,1950,1984,ACTRESS IN A SUPPORTING ROLE,34,1
Christoph Waltz,True,M,1956,2009,ACTOR IN A SUPPORTING ROLE,53,2
Christoph Waltz,True,M,1956,2012,ACTOR IN A SUPPORTING ROLE,56,2
Christopher Plummer,False,M,1929,2009,ACTOR IN A SUPPORTING ROLE,80,3
Christopher Plummer,False,M,1929,2017,ACTOR IN A SUPPORTING ROLE,88,3
Christopher Plummer,True,M,1929,2011,ACTOR IN A SUPPORTING ROLE,82,3
Christopher Walken,False,M,1943,2002,ACTOR IN A SUPPORTING ROLE,59,2
Christopher Walken,True,M,1943,1978,ACTOR IN A SUPPORTING ROLE,35,2
Cicely Tyson,False,F,1924,1972,ACTRESS,48,1
Claire Trevor,False,F,1910,1937,ACTRESS IN A SUPPORTING ROLE,27,3
Claire Trevor,False,F,1910,1954,ACTRESS IN A SUPPORTING ROLE,44,3
Claire Trevor,True,F,1910,1948,ACTRESS IN A SUPPORTING ROLE,38,3
Clark Gable,False,M,1901,1935,ACTOR,34,3
Clark Gable,False,M,1901,1939,ACTOR,38,3
Clark Gable,True,M,1901,1934,ACTOR,33,3
Claude Rains,False,M,1889,1939,ACTOR IN A SUPPORTING ROLE,50,4
Claude Rains,False,M,1889,1943,ACTOR IN A SUPPORTING ROLE,54,4
Claude Rains,False,M,1889,1944,ACTOR IN A SUPPORTING ROLE,55,4
Claude Rains,False,M,1889,1946,ACTOR IN A SUPPORTING ROLE,57,4
Claudette Colbert,False,F,1903,1935,ACTRESS,32,3
Claudette Colbert,False,F,1903,1944,ACTRESS,41,3
Claudette Colbert,True,F,1903,1934,ACTRESS,31,3
Cliff Robertson,True,M,1923,1968,ACTOR,45,1
Clifton Webb,False,M,1889,1944,ACTOR IN A SUPPORTING ROLE,55,3
Clifton Webb,False,M,1889,1946,ACTOR IN A SUPPORTING ROLE,57,3
Clifton Webb,False,M,1889,1948,ACTOR,59,3
Clint Eastwood,False,M,1930,1992,ACTOR IN A LEADING ROLE,62,2
Clint Eastwood,False,M,1930,2004,ACTOR IN A LEADING ROLE,74,2
Clive Owen,False,M,1964,2004,ACTOR IN A SUPPORTING ROLE,40,1
Cloris Leachman,True,F,1926,1971,ACTRESS IN A SUPPORTING ROLE,45,1
Colette Marchand,False,F,1925,1952,ACTRESS IN A SUPPORTING ROLE,27,1
Colin Firth,False,M,1960,2009,ACTOR IN A LEADING ROLE,49,2
Colin Firth,True,M,1960,2010,ACTOR IN A LEADING ROLE,50,2
Corinne Griffith,False,F,1894,1928,ACTRESS,34,1
Cornel Wilde,False,M,1912,1945,ACTOR,33,1
Cynthia Erivo,False,F,1987,2019,ACTRESS IN A LEADING ROLE,32,1
Dan Aykroyd,False,M,1952,1989,ACTOR IN A SUPPORTING ROLE,37,1
Dan Dailey,False,M,1915,1948,ACTOR,33,1
Dan O'Herlihy,False,M,1919,1954,ACTOR,35,1
Daniel Day-Lewis,False,M,1957,1993,ACTOR IN A LEADING ROLE,36,5
Daniel Day-Lewis,False,M,1957,2002,ACTOR IN A LEADING ROLE,45,5
Daniel Day-Lewis,False,M,1957,2017,ACTOR IN A LEADING ROLE,60,5
Daniel Day-Lewis,True,M,1957,2007,ACTOR IN A LEADING ROLE,50,5
Daniel Day-Lewis,True,M,1957,2012,ACTOR IN A LEADING ROLE,55,5
Daniel Kaluuya,False,M,1989,2017,ACTOR IN A LEADING ROLE,28,1
Daniel Massey,False,M,1933,1968,ACTOR IN A SUPPORTING ROLE,35,1
Danny Aiello,False,M,1933,1989,ACTOR IN A SUPPORTING ROLE,56,1
David Niven,True,M,1910,1958,ACTOR,48,1
David Paymer,False,M,1954,1992,ACTOR IN A SUPPORTING ROLE,38,1
David Strathairn,False,M,1949,2005,ACTOR IN A LEADING ROLE,56,1
Dean Jagger,True,M,1903,1949,ACTOR IN A SUPPORTING ROLE,46,1
Dean Stockwell,False,M,1936,1988,ACTOR IN A SUPPORTING ROLE,52,1
Debbie Reynolds,False,F,1932,1964,ACTRESS,32,1
Deborah Kerr,False,F,1921,1949,ACTRESS,28,6
Deborah Kerr,False,F,1921,1953,ACTRESS,32,6
Deborah Kerr,False,F,1921,1956,ACTRESS,35,6
Deborah Kerr,False,F,1921,1957,ACTRESS,36,6
Deborah Kerr,False,F,1921,1958,ACTRESS,37,6
Deborah Kerr,False,F,1921,1960,ACTRESS,39,6
Debra Winger,False,F,1955,1982,ACTRESS IN A LEADING ROLE,27,3
Debra Winger,False,F,1955,1983,ACTRESS IN A LEADING ROLE,28,3
Debra Winger,False,F,1955,1993,ACTRESS IN A LEADING ROLE,38,3
Demián Bichir,False,M,1963,2011,ACTOR IN A LEADING ROLE,48,1
Denholm Elliott,False,M,1922,1986,ACTOR IN A SUPPORTING ROLE,64,1
Dennis Hopper,False,M,1936,1986,ACTOR IN A SUPPORTING ROLE,50,1
Denzel Washington,False,M,1954,1987,ACTOR IN A SUPPORTING ROLE,33,8
Denzel Washington,False,M,1954,1992,ACTOR IN A LEADING ROLE,38,8
Denzel Washington,False,M,1954,1999,ACTOR IN A LEADING ROLE,45,8
Denzel Washington,False,M,1954,2012,ACTOR IN A LEADING ROLE,58,8
Denzel Washington,False,M,1954,2016,ACTOR IN A LEADING ROLE,62,8
Denzel Washington,False,M,1954,2017,ACTOR IN A LEADING ROLE,63,8
Denzel Washington,True,M,1954,1989,ACTOR IN A SUPPORTING ROLE,35,8
Denzel Washington,True,M,1954,2001,ACTOR IN A LEADING ROLE,47,8
Dev Patel,False,M,1990,2016,ACTOR IN A SUPPORTING ROLE,26,1
Dexter Gordon,False,M,1923,1986,ACTOR IN A LEADING ROLE,63,1
Diahann Carroll,False,F,1935,1974,ACTRESS,39,1
Diana Ross,False,F,1944,1972,ACTRESS,28,1
Diana Scarwid,False,F,1955,1980,ACTRESS IN A SUPPORTING ROLE,25,1
Diana Wynyard,False,F,1906,1932,ACTRESS,26,1
Diane Cilento,False,F,1932,1963,ACTRESS IN A SUPPORTING ROLE,31,1
Diane Keaton,False,F,1946,1981,ACTRESS IN A LEADING ROLE,35,4
Diane Keaton,False,F,1946,1996,ACTRESS IN A LEADING ROLE,50,4
Diane Keaton,False,F,1946,2003,ACTRESS IN A LEADING ROLE,57,4
Diane Keaton,True,F,1946,1977,ACTRESS IN A LEADING ROLE,31,4
Diane Ladd,False,F,1935,1974,ACTRESS IN A SUPPORTING ROLE,39,3
Diane Ladd,False,F,1935,1990,ACTRESS IN A SUPPORTING ROLE,55,3
Diane Ladd,False,F,1935,1991,ACTRESS IN A SUPPORTING ROLE,56,3
Diane Lane,False,F,1965,2002,ACTRESS IN A LEADING ROLE,37,1
Diane Varsi,False,F,1938,1957,ACTRESS IN A SUPPORTING ROLE,19,1
Dianne Wiest,False,F,1946,1989,ACTRESS IN A SUPPORTING ROLE,43,3
Dianne Wiest,True,F,1946,1986,ACTRESS IN A SUPPORTING ROLE,40,3
Dianne Wiest,True,F,1946,1994,ACTRESS IN A SUPPORTING ROLE,48,3
Djimon Hounsou,False,M,1964,2003,ACTOR IN A SUPPORTING ROLE,39,2
Djimon Hounsou,False,M,1964,2006,ACTOR IN A SUPPORTING ROLE,42,2
Don Ameche,True,M,1908,1985,ACTOR IN A SUPPORTING ROLE,77,1
Don Cheadle,False,M,1964,2004,ACTOR IN A LEADING ROLE,40,1
Don Murray,False,M,1929,1956,ACTOR IN A SUPPORTING ROLE,27,1
Donald Crisp,True,M,1882,1941,ACTOR IN A SUPPORTING ROLE,59,1
Donna Reed,True,F,1921,1953,ACTRESS IN A SUPPORTING ROLE,32,1
Doris Day,False,F,1922,1959,ACTRESS,37,1
Dorothy Dandridge,False,F,1922,1954,ACTRESS,32,1
Dorothy Malone,True,F,1924,1956,ACTRESS IN A SUPPORTING ROLE,32,1
Dorothy McGuire,False,F,1916,1947,ACTRESS,31,1
Dudley Moore,False,M,1935,1981,ACTOR IN A LEADING ROLE,46,1
Dustin Hoffman,False,M,1937,1967,ACTOR,30,7
Dustin Hoffman,False,M,1937,1969,ACTOR,32,7
Dustin Hoffman,False,M,1937,1974,ACTOR,37,7
Dustin Hoffman,False,M,1937,1982,ACTOR IN A LEADING ROLE,45,7
Dustin Hoffman,False,M,1937,1997,ACTOR IN A LEADING ROLE,60,7
Dustin Hoffman,True,M,1937,1979,ACTOR IN A LEADING ROLE,42,7
Dustin Hoffman,True,M,1937,1988,ACTOR IN A LEADING ROLE,51,7
Dyan Cannon,False,F,1937,1969,ACTRESS IN A SUPPORTING ROLE,32,2
Dyan Cannon,False,F,1937,1978,ACTRESS IN A SUPPORTING ROLE,41,2
Ed Begley,True,M,1901,1962,ACTOR IN A SUPPORTING ROLE,61,1
Ed Harris,False,M,1950,1995,ACTOR IN A SUPPORTING ROLE,45,4
Ed Harris,False,M,1950,1998,ACTOR IN A SUPPORTING ROLE,48,4
Ed Harris,False,M,1950,2000,ACTOR IN A LEADING ROLE,50,4
Ed Harris,False,M,1950,2002,ACTOR IN A SUPPORTING ROLE,52,4
Ed Wynn,False,M,1886,1959,ACTOR IN A SUPPORTING ROLE,73,1
Eddie Albert,False,M,1906,1953,ACTOR IN A SUPPORTING ROLE,47,2
Eddie Albert,False,M,1906,1972,ACTOR IN A SUPPORTING ROLE,66,2
Eddie Murphy,False,M,1961,2006,ACTOR IN A SUPPORTING ROLE,45,1
Eddie Redmayne,False,M,1982,2015,ACTOR IN A LEADING ROLE,33,2
Eddie Redmayne,True,M,1982,2014,ACTOR IN A LEADING ROLE,32,2
Edmond O'Brien,False,M,1915,1964,ACTOR IN A SUPPORTING ROLE,49,2
Edmond O'Brien,True,M,1915,1954,ACTOR IN A SUPPORTING ROLE,39,2
Edmund Gwenn,False,M,1877,1950,ACTOR IN A SUPPORTING ROLE,73,2
Edmund Gwenn,True,M,1877,1947,ACTOR IN A SUPPORTING ROLE,70,2
Edna May Oliver,False,F,1883,1939,ACTRESS IN A SUPPORTING ROLE,56,1
Edward James Olmos,False,M,1947,1988,ACTOR IN A LEADING ROLE,41,1
Edward Norton,False,M,1969,1996,ACTOR IN A SUPPORTING ROLE,27,3
Edward Norton,False,M,1969,1998,ACTOR IN A LEADING ROLE,29,3
Edward Norton,False,M,1969,2014,ACTOR IN A SUPPORTING ROLE,45,3
Eileen Brennan,False,F,1932,1980,ACTRESS IN A SUPPORTING ROLE,48,1
Eileen Heckart,False,F,1919,1956,ACTRESS IN A SUPPORTING ROLE,37,2
Eileen Heckart,True,F,1919,1972,ACTRESS IN A SUPPORTING ROLE,53,2
Eleanor Parker,False,F,1922,1950,ACTRESS,28,3
Eleanor Parker,False,F,1922,1951,ACTRESS,29,3
Eleanor Parker,False,F,1922,1955,ACTRESS,33,3
Elisabeth Bergner,False,F,1897,1935,ACTRESS,38,1
Elisabeth Shue,False,F,1963,1995,ACTRESS IN A LEADING ROLE,32,1
Elizabeth Hartman,False,F,1943,1965,ACTRESS,22,1
Elizabeth McGovern,False,F,1961,1981,ACTRESS IN A SUPPORTING ROLE,20,1
Elizabeth Taylor,False,F,1932,1957,ACTRESS,25,5
Elizabeth Taylor,False,F,1932,1958,ACTRESS,26,5
Elizabeth Taylor,False,F,1932,1959,ACTRESS,27,5
Elizabeth Taylor,True,F,1932,1960,ACTRESS,28,5
Elizabeth Taylor,True,F,1932,1966,ACTRESS,34,5
Ellen Burstyn,False,F,1932,1971,ACTRESS IN A SUPPORTING ROLE,39,6
Ellen Burstyn,False,F,1932,1973,ACTRESS,41,6
Ellen Burstyn,False,F,1932,1978,ACTRESS IN A LEADING ROLE,46,6
Ellen Burstyn,False,F,1932,1980,ACTRESS IN A LEADING ROLE,48,6
Ellen Burstyn,False,F,1932,2000,ACTRESS IN A LEADING ROLE,68,6
Ellen Burstyn,True,F,1932,1974,ACTRESS,42,6
Ellen Corby,False,F,1911,1948,ACTRESS IN A SUPPORTING ROLE,37,1
Elliott Gould,False,M,1938,1969,ACTOR IN A SUPPORTING ROLE,31,1
Elsa Lanchester,False,F,1902,1949,ACTRESS IN A SUPPORTING ROLE,47,2
Elsa Lanchester,False,F,1902,1957,ACTRESS IN A SUPPORTING ROLE,55,2
Emil Jannings,True,M,1884,1927,ACTOR,43,1
Emily Watson,False,F,1967,1996,ACTRESS IN A LEADING ROLE,29,2
Emily Watson,False,F,1967,1998,ACTRESS IN A LEADING ROLE,31,2
Emma Stone,False,F,1988,2014,ACTRESS IN A SUPPORTING ROLE,26,3
Emma Stone,False,F,1988,2018,ACTRESS IN A SUPPORTING ROLE,30,3
Emma Stone,True,F,1988,2016,ACTRESS IN A LEADING ROLE,28,3
Emma Thompson,False,F,1959,1993,ACTRESS IN A LEADING ROLE,34,4
Emma Thompson,False,F,1959,1993,ACTRESS IN A SUPPORTING ROLE,34,4
Emma Thompson,False,F,1959,1995,ACTRESS IN A LEADING ROLE,36,4
Emma Thompson,True,F,1959,1992,ACTRESS IN A LEADING ROLE,33,4
Emmanuelle Riva,False,F,1927,2012,ACTRESS IN A LEADING ROLE,85,1
Eric Roberts,False,M,1956,1985,ACTOR IN A SUPPORTING ROLE,29,1
Erich von Stroheim,False,M,1885,1950,ACTOR IN A SUPPORTING ROLE,65,1
Ernest Borgnine,True,M,1917,1955,ACTOR,38,1
Estelle Parsons,False,F,1927,1968,ACTRESS IN A SUPPORTING ROLE,41,2
Estelle Parsons,True,F,1927,1967,ACTRESS IN A SUPPORTING ROLE,40,2
Ethan Hawke,False,M,1970,2001,ACTOR IN A SUPPORTING ROLE,31,2
Ethan Hawke,False,M,1970,2014,ACTOR IN A SUPPORTING ROLE,44,2
Ethel Barrymore,False,F,1879,1946,ACTRESS IN A SUPPORTING ROLE,67,4
Ethel Barrymore,False,F,1879,1947,ACTRESS IN A SUPPORTING ROLE,68,4
Ethel Barrymore,False,F,1879,1949,ACTRESS IN A SUPPORTING ROLE,70,4
Ethel Barrymore,True,F,1879,1944,ACTRESS IN A SUPPORTING ROLE,65,4
Ethel Waters,False,F,1896,1949,ACTRESS IN A SUPPORTING ROLE,53,1
Eva Le Gallienne,False,F,1899,1980,ACTRESS IN A SUPPORTING ROLE,81,1
Eva Marie Saint,True,F,1924,1954,ACTRESS IN A SUPPORTING ROLE,30,1
Eve Arden,False,F,1908,1945,ACTRESS IN A SUPPORTING ROLE,37,1
F. Murray Abraham,True,M,1939,1984,ACTOR IN A LEADING ROLE,45,1
Fay Bainter,False,F,1893,1938,ACTRESS,45,3
Fay Bainter,False,F,1893,1961,ACTRESS IN A SUPPORTING ROLE,68,3
Fay Bainter,True,F,1893,1938,ACTRESS IN A SUPPORTING ROLE,45,3
Faye Dunaway,False,F,1941,1967,ACTRESS,26,3
Faye Dunaway,False,F,1941,1974,ACTRESS,33,3
Faye Dunaway,True,F,1941,1976,ACTRESS IN A LEADING ROLE,35,3
Felicity Huffman,False,F,1962,2005,ACTRESS IN A LEADING ROLE,43,1
Felicity Jones,False,F,1983,2014,ACTRESS IN A LEADING ROLE,31,1
Fernanda Montenegro,False,F,1929,1998,ACTRESS IN A LEADING ROLE,69,1
Flora Robson,False,F,1902,1946,ACTRESS IN A SUPPORTING ROLE,44,1
Florence Pugh,False,F,1996,2019,ACTRESS IN A SUPPORTING ROLE,23,1
Forest Whitaker,True,M,1961,2006,ACTOR IN A LEADING ROLE,45,1
Frances McDormand,False,F,1957,1988,ACTRESS IN A SUPPORTING ROLE,31,5
Frances McDormand,False,F,1957,2000,ACTRESS IN A SUPPORTING ROLE,43,5
Frances McDormand,False,F,1957,2005,ACTRESS IN A SUPPORTING ROLE,48,5
Frances McDormand,True,F,1957,1996,ACTRESS IN A LEADING ROLE,39,5
Frances McDormand,True,F,1957,2017,ACTRESS IN A LEADING ROLE,60,5
Franchot Tone,False,M,1905,1935,ACTOR,30,1
Frank Finlay,False,M,1926,1965,ACTOR IN A SUPPORTING ROLE,39,1
Frank Langella,False,M,1938,2008,ACTOR IN A LEADING ROLE,70,1
Frank Morgan,False,M,1890,1934,ACTOR,44,2
Frank Morgan,False,M,1890,1942,ACTOR IN A SUPPORTING ROLE,52,2
Frank Sinatra,False,M,1915,1955,ACTOR,40,2
Frank Sinatra,True,M,1915,1953,ACTOR IN A SUPPORTING ROLE,38,2
Fred Astaire,False,M,1899,1974,ACTOR IN A SUPPORTING ROLE,75,1
Frederic Forrest,False,M,1936,1979,ACTOR IN A SUPPORTING ROLE,43,1
Fredric March,False,M,1897,1930,ACTOR,33,5
Fredric March,False,M,1897,1937,ACTOR,40,5
Fredric March,False,M,1897,1951,ACTOR,54,5
Fredric March,True,M,1897,1931,ACTOR,34,5
Fredric March,True,M,1897,1946,ACTOR,49,5
Gabourey Sidibe,False,F,1983,2009,ACTRESS IN A LEADING ROLE,26,1
Gale Sondergaard,False,F,1899,1946,ACTRESS IN A SUPPORTING ROLE,47,2
Gale Sondergaard,True,F,1899,1936,ACTRESS IN A SUPPORTING ROLE,37,2
Gary Busey,False,M,1944,1978,ACTOR IN A LEADING ROLE,34,1
Gary Cooper,False,M,1901,1936,ACTOR,35,5
Gary Cooper,False,M,1901,1942,ACTOR,41,5
Gary Cooper,False,M,1901,1943,ACTOR,42,5
Gary Cooper,True,M,1901,1941,ACTOR,40,5
Gary Cooper,True,M,1901,1952,ACTOR,51,5
Gary Oldman,False,M,1958,2011,ACTOR IN A LEADING ROLE,53,2
Gary Oldman,True,M,1958,2017,ACTOR IN A LEADING ROLE,59,2
Gary Sinise,False,M,1955,1994,ACTOR IN A SUPPORTING ROLE,39,1
Geena Davis,False,F,1956,1991,ACTRESS IN A LEADING ROLE,35,2
Geena Davis,True,F,1956,1988,ACTRESS IN A SUPPORTING ROLE,32,2
Gena Rowlands,False,F,1930,1974,ACTRESS,44,2
Gena Rowlands,False,F,1930,1980,ACTRESS IN A LEADING ROLE,50,2
Gene Hackman,False,M,1930,1967,ACTOR IN A SUPPORTING ROLE,37,5
Gene Hackman,False,M,1930,1970,ACTOR IN A SUPPORTING ROLE,40,5
Gene Hackman,False,M,1930,1988,ACTOR IN A LEADING ROLE,58,5
Gene Hackman,True,M,1930,1971,ACTOR,41,5
Gene Hackman,True,M,1930,1992,ACTOR IN A SUPPORTING ROLE,62,5
Gene Kelly,False,M,1912,1945,ACTOR,33,1
Gene Lockhart,False,M,1891,1938,ACTOR IN A SUPPORTING ROLE,47,1
Gene Tierney,False,F,1920,1945,ACTRESS,25,1
Gene Wilder,False,M,1933,1968,ACTOR IN A SUPPORTING ROLE,35,1
Geoffrey Rush,False,M,1951,1998,ACTOR IN A SUPPORTING ROLE,47,4
Geoffrey Rush,False,M,1951,2000,ACTOR IN A LEADING ROLE,49,4
Geoffrey Rush,False,M,1951,2010,ACTOR IN A SUPPORTING ROLE,59,4
Geoffrey Rush,True,M,1951,1996,ACTOR IN A LEADING ROLE,45,4
George Arliss,False,M,1868,1929,ACTOR,61,2
George Arliss,True,M,1868,1929,ACTOR,61,2
George Bancroft,False,M,1882,1928,ACTOR,46,1
George Burns,True,M,1896,1975,ACTOR IN A SUPPORTING ROLE,79,1
George C. Scott,False,M,1927,1959,ACTOR IN A SUPPORTING ROLE,32,4
George C. Scott,False,M,1927,1961,ACTOR IN A SUPPORTING ROLE,34,4
George C. Scott,False,M,1927,1971,ACTOR,44,4
George C. Scott,True,M,1927,1970,ACTOR,43,4
George Chakiris,True,M,1934,1961,ACTOR IN A SUPPORTING ROLE,27,1
George Clooney,False,M,1961,2007,ACTOR IN A LEADING ROLE,46,4
George Clooney,False,M,1961,2009,ACTOR IN A LEADING ROLE,48,4
George Clooney,False,M,1961,2011,ACTOR IN A LEADING ROLE,50,4
George Clooney,True,M,1961,2005,ACTOR IN A SUPPORTING ROLE,44,4
George Kennedy,True,M,1925,1967,ACTOR IN A SUPPORTING ROLE,42,1
George Sanders,True,M,1906,1950,ACTOR IN A SUPPORTING ROLE,44,1
George Segal,False,M,1934,1966,ACTOR IN A SUPPORTING ROLE,32,1
Geraldine Fitzgerald,False,F,1913,1939,ACTRESS IN A SUPPORTING ROLE,26,1
Geraldine Page,False,F,1924,1953,ACTRESS IN A SUPPORTING ROLE,29,8
Geraldine Page,False,F,1924,1961,ACTRESS,37,8
Geraldine Page,False,F,1924,1962,ACTRESS,38,8
Geraldine Page,False,F,1924,1966,ACTRESS IN A SUPPORTING ROLE,42,8
Geraldine Page,False,F,1924,1972,ACTRESS IN A SUPPORTING ROLE,48,8
Geraldine Page,False,F,1924,1978,ACTRESS IN A LEADING ROLE,54,8
Geraldine Page,False,F,1924,1984,ACTRESS IN A SUPPORTING ROLE,60,8
Geraldine Page,True,F,1924,1985,ACTRESS IN A LEADING ROLE,61,8
Giancarlo Giannini,False,M,1942,1976,ACTOR IN A LEADING ROLE,34,1
Gig Young,False,M,1913,1951,ACTOR IN A SUPPORTING ROLE,38,3
Gig Young,False,M,1913,1958,ACTOR IN A SUPPORTING ROLE,45,3
Gig Young,True,M,1913,1969,ACTOR IN A SUPPORTING ROLE,56,3
Ginger Rogers,True,F,1911,1940,ACTRESS,29,1
Gladys Cooper,False,F,1888,1942,ACTRESS IN A SUPPORTING ROLE,54,3
Gladys Cooper,False,F,1888,1943,ACTRESS IN A SUPPORTING ROLE,55,3
Gladys Cooper,False,F,1888,1964,ACTRESS IN A SUPPORTING ROLE,76,3
Gladys George,False,F,1900,1936,ACTRESS,36,1
Glenda Jackson,False,F,1936,1971,ACTRESS,35,4
Glenda Jackson,False,F,1936,1975,ACTRESS,39,4
Glenda Jackson,True,F,1936,1970,ACTRESS,34,4
Glenda Jackson,True,F,1936,1973,ACTRESS,37,4
Glenn Close,False,F,1947,1982,ACTRESS IN A SUPPORTING ROLE,35,7
Glenn Close,False,F,1947,1983,ACTRESS IN A SUPPORTING ROLE,36,7
Glenn Close,False,F,1947,1984,ACTRESS IN A SUPPORTING ROLE,37,7
Glenn Close,False,F,1947,1987,ACTRESS IN A LEADING ROLE,40,7
Glenn Close,False,F,1947,1988,ACTRESS IN A LEADING ROLE,41,7
Glenn Close,False,F,1947,2011,ACTRESS IN A LEADING ROLE,64,7
Glenn Close,False,F,1947,2018,ACTRESS IN A LEADING ROLE,71,7
Gloria Grahame,False,F,1923,1947,ACTRESS IN A SUPPORTING ROLE,24,2
Gloria Grahame,True,F,1923,1952,ACTRESS IN A SUPPORTING ROLE,29,2
Gloria Stuart,False,F,1910,1997,ACTRESS IN A SUPPORTING ROLE,87,1
Gloria Swanson,False,F,1899,1927,ACTRESS,28,3
Gloria Swanson,False,F,1899,1929,ACTRESS,30,3
Gloria Swanson,False,F,1899,1950,ACTRESS,51,3
Glynis Johns,False,F,1923,1960,ACTRESS IN A SUPPORTING ROLE,37,1
Goldie Hawn,False,F,1945,1980,ACTRESS IN A LEADING ROLE,35,2
Goldie Hawn,True,F,1945,1969,ACTRESS IN A SUPPORTING ROLE,24,2
Grace Kelly,False,F,1929,1953,ACTRESS IN A SUPPORTING ROLE,24,2
Grace Kelly,True,F,1929,1954,ACTRESS,25,2
Grace Moore,False,F,1898,1934,ACTRESS,36,1
Graham Greene,False,M,1904,1990,ACTOR IN A SUPPORTING ROLE,86,1
Grayson Hall,False,F,1922,1964,ACTRESS IN A SUPPORTING ROLE,42,1
Greer Garson,False,F,1904,1939,ACTRESS,35,7
Greer Garson,False,F,1904,1941,ACTRESS,37,7
Greer Garson,False,F,1904,1943,ACTRESS,39,7
Greer Garson,False,F,1904,1944,ACTRESS,40,7
Greer Garson,False,F,1904,1945,ACTRESS,41,7
Greer Garson,False,F,1904,1960,ACTRESS,56,7
Greer Garson,True,F,1904,1942,ACTRESS,38,7
Greg Kinnear,False,M,1963,1997,ACTOR IN A SUPPORTING ROLE,34,1
Gregory Peck,False,M,1916,1945,ACTOR,29,5
Gregory Peck,False,M,1916,1946,ACTOR,30,5
Gregory Peck,False,M,1916,1947,ACTOR,31,5
Gregory Peck,False,M,1916,1949,ACTOR,33,5
Gregory Peck,True,M,1916,1962,ACTOR,46,5
Greta Garbo,False,F,1905,1929,ACTRESS,24,3
Greta Garbo,False,F,1905,1937,ACTRESS,32,3
Greta Garbo,False,F,1905,1939,ACTRESS,34,3
Gwyneth Paltrow,True,F,1972,1998,ACTRESS IN A LEADING ROLE,26,1
Hailee Steinfeld,False,F,1996,2010,ACTRESS IN A SUPPORTING ROLE,14,1
Haing S. Ngor,True,M,1940,1984,ACTOR IN A SUPPORTING ROLE,44,1
Hal Holbrook,False,M,1925,2007,ACTOR IN A SUPPORTING ROLE,82,1
Haley Joel Osment,False,M,1988,1999,ACTOR IN A SUPPORTING ROLE,11,1
Halle Berry,True,F,1966,2001,ACTRESS IN A LEADING ROLE,35,1
Harold Russell,True,M,1914,1946,ACTOR IN A SUPPORTING ROLE,32,1
Harrison Ford,False,M,1942,1985,ACTOR IN A LEADING ROLE,43,1
Harry Carey,False,M,1878,1939,ACTOR IN A SUPPORTING ROLE,61,1
Harvey Keitel,False,M,1939,1991,ACTOR IN A SUPPORTING ROLE,52,1
Hattie McDaniel,True,F,1893,1939,ACTRESS IN A SUPPORTING ROLE,46,1
Heath Ledger,False,M,1979,2005,ACTOR IN A LEADING ROLE,26,2
Heath Ledger,True,M,1979,2008,ACTOR IN A SUPPORTING ROLE,29,2
Helen Hayes,True,F,1900,1931,ACTRESS,31,2
Helen Hayes,True,F,1900,1970,ACTRESS IN A SUPPORTING ROLE,70,2
Helen Hunt,False,F,1963,2012,ACTRESS IN A SUPPORTING ROLE,49,2
Helen Hunt,True,F,1963,1997,ACTRESS IN A LEADING ROLE,34,2
Helen Mirren,False,F,1945,1994,ACTRESS IN A SUPPORTING ROLE,49,4
Helen Mirren,False,F,1945,2001,ACTRESS IN A SUPPORTING ROLE,56,4
Helen Mirren,False,F,1945,2009,ACTRESS IN A LEADING ROLE,64,4
Helen Mirren,True,F,1945,2006,ACTRESS IN A LEADING ROLE,61,4
Helena Bonham Carter,False,F,1966,1997,ACTRESS IN A LEADING ROLE,31,2
Helena Bonham Carter,False,F,1966,2010,ACTRESS IN A SUPPORTING ROLE,44,2
Henry Fonda,False,M,1905,1940,ACTOR,35,2
Henry Fonda,True,M,1905,1981,ACTOR IN A LEADING ROLE,76,2
Henry Travers,False,M,1874,1942,ACTOR IN A SUPPORTING ROLE,68,1
Hermione Baddeley,False,F,1906,1959,ACTRESS IN A SUPPORTING ROLE,53,1
Hilary Swank,True,F,1974,1999,ACTRESS IN A LEADING ROLE,25,2
Hilary Swank,True,F,1974,2004,ACTRESS IN A LEADING ROLE,30,2
Holly Hunter,False,F,1958,1987,ACTRESS IN A LEADING ROLE,29,4
Holly Hunter,False,F,1958,1993,ACTRESS IN A SUPPORTING ROLE,35,4
Holly Hunter,False,F,1958,2003,ACTRESS IN A SUPPORTING ROLE,45,4
Holly Hunter,True,F,1958,1993,ACTRESS IN A LEADING ROLE,35,4
Hope Emerson,False,F,1897,1950,ACTRESS IN A SUPPORTING ROLE,53,1
Hope Lange,False,F,1933,1957,ACTRESS IN A SUPPORTING ROLE,24,1
Hugh Griffith,False,M,1912,1963,ACTOR IN A SUPPORTING ROLE,51,2
Hugh Griffith,True,M,1912,1959,ACTOR IN A SUPPORTING ROLE,47,2
Hugh Jackman,False,M,1968,2012,ACTOR IN A LEADING ROLE,44,1
Hume Cronyn,False,M,1911,1944,ACTOR IN A SUPPORTING ROLE,33,1
Humphrey Bogart,False,M,1899,1943,ACTOR,44,3
Humphrey Bogart,False,M,1899,1954,ACTOR,55,3
Humphrey Bogart,True,M,1899,1951,ACTOR,52,3
Ian Bannen,False,M,1928,1965,ACTOR IN A SUPPORTING ROLE,37,1
Ian Holm,False,M,1931,1981,ACTOR IN A SUPPORTING ROLE,50,1
Ian McKellen,False,M,1939,1998,ACTOR IN A LEADING ROLE,59,2
Ian McKellen,False,M,1939,2001,ACTOR IN A SUPPORTING ROLE,62,2
Imelda Staunton,False,F,1956,2004,ACTRESS IN A LEADING ROLE,48,1
Ingrid Bergman,False,F,1915,1943,ACTRESS,28,7
Ingrid Bergman,False,F,1915,1945,ACTRESS,30,7
Ingrid Bergman,False,F,1915,1948,ACTRESS,33,7
Ingrid Bergman,False,F,1915,1978,ACTRESS IN A LEADING ROLE,63,7
Ingrid Bergman,True,F,1915,1944,ACTRESS,29,7
Ingrid Bergman,True,F,1915,1956,ACTRESS,41,7
Ingrid Bergman,True,F,1915,1974,ACTRESS IN A SUPPORTING ROLE,59,7
Irene Dunne,False,F,1898,1930,ACTRESS,32,5
Irene Dunne,False,F,1898,1936,ACTRESS,38,5
Irene Dunne,False,F,1898,1937,ACTRESS,39,5
Irene Dunne,False,F,1898,1939,ACTRESS,41,5
Irene Dunne,False,F,1898,1948,ACTRESS,50,5
Isabelle Adjani,False,F,1955,1975,ACTRESS,20,2
Isabelle Adjani,False,F,1955,1989,ACTRESS IN A LEADING ROLE,34,2
Isabelle Huppert,False,F,1953,2016,ACTRESS IN A LEADING ROLE,63,1
J. Carrol Naish,False,M,1896,1943,ACTOR IN A SUPPORTING ROLE,47,2
J. Carrol Naish,False,M,1896,1945,ACTOR IN A SUPPORTING ROLE,49,2
J.K. Simmons,True,M,1955,2014,ACTOR IN A SUPPORTING ROLE,59,1
Jack Albertson,True,M,1907,1968,ACTOR IN A SUPPORTING ROLE,61,1
Jack Gilford,False,M,1908,1973,ACTOR IN A SUPPORTING ROLE,65,1
Jack Kruschen,False,M,1922,1960,ACTOR IN A SUPPORTING ROLE,38,1
Jack Lemmon,False,M,1925,1959,ACTOR,34,8
Jack Lemmon,False,M,1925,1960,ACTOR,35,8
Jack Lemmon,False,M,1925,1962,ACTOR,37,8
Jack Lemmon,False,M,1925,1979,ACTOR IN A LEADING ROLE,54,8
Jack Lemmon,False,M,1925,1980,ACTOR IN A LEADING ROLE,55,8
Jack Lemmon,False,M,1925,1982,ACTOR IN A LEADING ROLE,57,8
Jack Lemmon,True,M,1925,1955,ACTOR IN A SUPPORTING ROLE,30,8
Jack Lemmon,True,M,1925,1973,ACTOR,48,8
Jack Nicholson,False,M,1937,1969,ACTOR IN A SUPPORTING ROLE,32,12
Jack Nicholson,False,M,1937,1970,ACTOR,33,12
Jack Nicholson,False,M,1937,1973,ACTOR,36,12
Jack Nicholson,False,M,1937,1974,ACTOR,37,12
Jack Nicholson,False,M,1937,1981,ACTOR IN A SUPPORTING ROLE,44,12
Jack Nicholson,False,M,1937,1985,ACTOR IN A LEADING ROLE,48,12
Jack Nicholson,False,M,1937,1987,ACTOR IN A LEADING ROLE,50,12
Jack Nicholson,False,M,1937,1992,ACTOR IN A SUPPORTING ROLE,55,12
Jack Nicholson,False,M,1937,2002,ACTOR IN A LEADING ROLE,65,12
Jack Nicholson,True,M,1937,1975,ACTOR,38,12
Jack Nicholson,True,M,1937,1983,ACTOR IN A SUPPORTING ROLE,46,12
Jack Nicholson,True,M,1937,1997,ACTOR IN A LEADING ROLE,60,12
Jack Oakie,False,M,1903,1940,ACTOR IN A SUPPORTING ROLE,37,1
Jack Palance,False,M,1919,1952,ACTOR IN A SUPPORTING ROLE,33,3
Jack Palance,False,M,1919,1953,ACTOR IN A SUPPORTING ROLE,34,3
Jack Palance,True,M,1919,1991,ACTOR IN A SUPPORTING ROLE,72,3
Jack Warden,False,M,1920,1975,ACTOR IN A SUPPORTING ROLE,55,2
Jack Warden,False,M,1920,1978,ACTOR IN A SUPPORTING ROLE,58,2
Jack Wild,False,M,1952,1968,ACTOR IN A SUPPORTING ROLE,16,1
Jacki Weaver,False,F,1947,2010,ACTRESS IN A SUPPORTING ROLE,63,2
Jacki Weaver,False,F,1947,2012,ACTRESS IN A SUPPORTING ROLE,65,2
Jackie Cooper,False,M,1922,1930,ACTOR,8,1
Jackie Earle Haley,False,M,1961,2006,ACTOR IN A SUPPORTING ROLE,45,1
Jackie Gleason,False,M,1916,1961,ACTOR IN A SUPPORTING ROLE,45,1
Jake Gyllenhaal,False,M,1980,2005,ACTOR IN A SUPPORTING ROLE,25,1
James Caan,False,M,1940,1972,ACTOR IN A SUPPORTING ROLE,32,1
James Cagney,False,M,1899,1938,ACTOR,39,3
James Cagney,False,M,1899,1955,ACTOR,56,3
James Cagney,True,M,1899,1942,ACTOR,43,3
James Coburn,True,M,1928,1998,ACTOR IN A SUPPORTING ROLE,70,1
James Coco,False,M,1930,1981,ACTOR IN A SUPPORTING ROLE,51,1
James Cromwell,False,M,1940,1995,ACTOR IN A SUPPORTING ROLE,55,1
James Dean,False,M,1931,1955,ACTOR,24,2
James Dean,False,M,1931,1956,ACTOR,25,2
James Dunn,True,M,1901,1945,ACTOR IN A SUPPORTING ROLE,44,1
James Earl Jones,False,M,1931,1970,ACTOR,39,1
James Franco,False,M,1978,2010,ACTOR IN A LEADING ROLE,32,1
James Garner,False,M,1928,1985,ACTOR IN A LEADING ROLE,57,1
James Gleason,False,M,1882,1941,ACTOR IN A SUPPORTING ROLE,59,1
James Mason,False,M,1909,1954,ACTOR,45,3
James Mason,False,M,1909,1966,ACTOR IN A SUPPORTING ROLE,57,3
James Mason,False,M,1909,1982,ACTOR IN A SUPPORTING ROLE,73,3
James Stephenson,False,M,1889,1940,ACTOR IN A SUPPORTING ROLE,51,1
James Stewart,False,M,1908,1939,ACTOR,31,5
James Stewart,False,M,1908,1946,ACTOR,38,5
James Stewart,False,M,1908,1950,ACTOR,42,5
James Stewart,False,M,1908,1959,ACTOR,51,5
James Stewart,True,M,1908,1940,ACTOR,32,5
James Whitmore,False,M,1921,1949,ACTOR IN A SUPPORTING ROLE,28,2
James Whitmore,False,M,1921,1975,ACTOR,54,2
James Woods,False,M,1947,1986,ACTOR IN A LEADING ROLE,39,2
James Woods,False,M,1947,1996,ACTOR IN A SUPPORTING ROLE,49,2
Jamie Foxx,False,M,1967,2004,ACTOR IN A SUPPORTING ROLE,37,2
Jamie Foxx,True,M,1967,2004,ACTOR IN A LEADING ROLE,37,2
Jan Sterling,False,F,1921,1954,ACTRESS IN A SUPPORTING ROLE,33,1
Jane Alexander,False,F,1939,1970,ACTRESS,31,4
Jane Alexander,False,F,1939,1976,ACTRESS IN A SUPPORTING ROLE,37,4
Jane Alexander,False,F,1939,1979,ACTRESS IN A SUPPORTING ROLE,40,4
Jane Alexander,False,F,1939,1983,ACTRESS IN A LEADING ROLE,44,4
Jane Darwell,True,F,1879,1940,ACTRESS IN A SUPPORTING ROLE,61,1
Jane Fonda,False,F,1937,1969,ACTRESS,32,7
Jane Fonda,False,F,1937,1977,ACTRESS IN A LEADING ROLE,40,7
Jane Fonda,False,F,1937,1979,ACTRESS IN A LEADING ROLE,42,7
Jane Fonda,False,F,1937,1981,ACTRESS IN A SUPPORTING ROLE,44,7
Jane Fonda,False,F,1937,1986,ACTRESS IN A LEADING ROLE,49,7
Jane Fonda,True,F,1937,1971,ACTRESS,34,7
Jane Fonda,True,F,1937,1978,ACTRESS IN A LEADING ROLE,41,7
Jane Wyman,False,F,1917,1946,ACTRESS,29,4
Jane Wyman,False,F,1917,1951,ACTRESS,34,4
Jane Wyman,False,F,1917,1954,ACTRESS,37,4
Jane Wyman,True,F,1917,1948,ACTRESS,31,4
Janet Gaynor,False,F,1906,1937,ACTRESS,31,2
Janet Gaynor,True,F,1906,1927,ACTRESS,21,2
Janet Leigh,False,F,1927,1960,ACTRESS IN A SUPPORTING ROLE,33,1
Janet McTeer,False,F,1961,1999,ACTRESS IN A LEADING ROLE,38,2
Janet McTeer,False,F,1961,2011,ACTRESS IN A SUPPORTING ROLE,50,2
Janet Suzman,False,F,1939,1971,ACTRESS,32,1
Jared Leto,True,M,1971,2013,ACTOR IN A SUPPORTING ROLE,42,1
Jason Miller,False,M,1939,1973,ACTOR IN A SUPPORTING ROLE,34,1
Jason Robards,False,M,1922,1980,ACTOR IN A SUPPORTING ROLE,58,3
Jason Robards,True,M,1922,1976,ACTOR IN A SUPPORTING ROLE,54,3
Jason Robards,True,M,1922,1977,ACTOR IN A SUPPORTING ROLE,55,3
Javier Bardem,False,M,1969,2000,ACTOR IN A LEADING ROLE,31,3
Javier Bardem,False,M,1969,2010,ACTOR IN A LEADING ROLE,41,3
Javier Bardem,True,M,1969,2007,ACTOR IN A SUPPORTING ROLE,38,3
Jaye Davidson,False,M,1968,1992,ACTOR IN A SUPPORTING ROLE,24,1
Jean Arthur,False,F,1900,1943,ACTRESS,43,1
Jean Dujardin,True,M,1972,2011,ACTOR IN A LEADING ROLE,39,1
Jean Hagen,False,F,1923,1952,ACTRESS IN A SUPPORTING ROLE,29,1
Jean Simmons,False,F,1929,1948,ACTRESS IN A SUPPORTING ROLE,19,2
Jean Simmons,False,F,1929,1969,ACTRESS,40,2
Jeanne Crain,False,F,1925,1949,ACTRESS,24,1
Jeanne Eagels,False,F,1890,1928,ACTRESS,38,1
Jeannie Berlin,False,F,1949,1972,ACTRESS IN A SUPPORTING ROLE,23,1
Jeff Bridges,False,M,1949,1971,ACTOR IN A SUPPORTING ROLE,22,7
Jeff Bridges,False,M,1949,1974,ACTOR IN A SUPPORTING ROLE,25,7
Jeff Bridges,False,M,1949,1984,ACTOR IN A LEADING ROLE,35,7
Jeff Bridges,False,M,1949,2000,ACTOR IN A SUPPORTING ROLE,51,7
Jeff Bridges,False,M,1949,2010,ACTOR IN A LEADING ROLE,61,7
Jeff Bridges,False,M,1949,2016,ACTOR IN A SUPPORTING ROLE,67,7
Jeff Bridges,True,M,1949,2009,ACTOR IN A LEADING ROLE,60,7
Jeff Chandler,False,M,1918,1950,ACTOR IN A SUPPORTING ROLE,32,1
Jennifer Connelly,True,F,1970,2001,ACTRESS IN A SUPPORTING ROLE,31,1
Jennifer Hudson,True,F,1981,2006,ACTRESS IN A SUPPORTING ROLE,25,1
Jennifer Jason Leigh,False,F,1962,2015,ACTRESS IN A SUPPORTING ROLE,53,1
Jennifer Jones,False,F,1919,1944,ACTRESS IN A SUPPORTING ROLE,25,5
Jennifer Jones,False,F,1919,1945,ACTRESS,26,5
Jennifer Jones,False,F,1919,1946,ACTRESS,27,5
Jennifer Jones,False,F,1919,1955,ACTRESS,36,5
Jennifer Jones,True,F,1919,1943,ACTRESS,24,5
Jennifer Lawrence,False,F,1990,2010,ACTRESS IN A LEADING ROLE,20,4
Jennifer Lawrence,False,F,1990,2013,ACTRESS IN A SUPPORTING ROLE,23,4
Jennifer Lawrence,False,F,1990,2015,ACTRESS IN A LEADING ROLE,25,4
Jennifer Lawrence,True,F,1990,2012,ACTRESS IN A LEADING ROLE,22,4
Jennifer Tilly,False,F,1958,1994,ACTRESS IN A SUPPORTING ROLE,36,1
Jeremy Irons,True,M,1948,1990,ACTOR IN A LEADING ROLE,42,1
Jeremy Renner,False,M,1971,2009,ACTOR IN A LEADING ROLE,38,2
Jeremy Renner,False,M,1971,2010,ACTOR IN A SUPPORTING ROLE,39,2
Jesse Eisenberg,False,M,1983,2010,ACTOR IN A LEADING ROLE,27,1
Jessica Chastain,False,F,1977,2011,ACTRESS IN A SUPPORTING ROLE,34,2
Jessica Chastain,False,F,1977,2012,ACTRESS IN A LEADING ROLE,35,2
Jessica Lange,False,F,1949,1982,ACTRESS IN A LEADING ROLE,33,6
Jessica Lange,False,F,1949,1984,ACTRESS IN A LEADING ROLE,35,6
Jessica Lange,False,F,1949,1985,ACTRESS IN A LEADING ROLE,36,6
Jessica Lange,False,F,1949,1989,ACTRESS IN A LEADING ROLE,40,6
Jessica Lange,True,F,1949,1982,ACTRESS IN A SUPPORTING ROLE,33,6
Jessica Lange,True,F,1949,1994,ACTRESS IN A LEADING ROLE,45,6
Jessica Tandy,False,F,1909,1991,ACTRESS IN A SUPPORTING ROLE,82,2
Jessica Tandy,True,F,1909,1989,ACTRESS IN A LEADING ROLE,80,2
Jill Clayburgh,False,F,1944,1978,ACTRESS IN A LEADING ROLE,34,2
Jill Clayburgh,False,F,1944,1979,ACTRESS IN A LEADING ROLE,35,2
Jim Broadbent,True,M,1949,2001,ACTOR IN A SUPPORTING ROLE,52,1
Jo Van Fleet,True,F,1915,1955,ACTRESS IN A SUPPORTING ROLE,40,1
Joan Allen,False,F,1956,1995,ACTRESS IN A SUPPORTING ROLE,39,3
Joan Allen,False,F,1956,1996,ACTRESS IN A SUPPORTING ROLE,40,3
Joan Allen,False,F,1956,2000,ACTRESS IN A LEADING ROLE,44,3
Joan Blondell,False,F,1906,1951,ACTRESS IN A SUPPORTING ROLE,45,1
Joan Crawford,False,F,1904,1947,ACTRESS,43,3
Joan Crawford,False,F,1904,1952,ACTRESS,48,3
Joan Crawford,True,F,1904,1945,ACTRESS,41,3
Joan Cusack,False,F,1962,1988,ACTRESS IN A SUPPORTING ROLE,26,2
Joan Cusack,False,F,1962,1997,ACTRESS IN A SUPPORTING ROLE,35,2
Joan Fontaine,False,F,1917,1940,ACTRESS,23,3
Joan Fontaine,False,F,1917,1943,ACTRESS,26,3
Joan Fontaine,True,F,1917,1941,ACTRESS,24,3
Joan Hackett,False,F,1934,1981,ACTRESS IN A SUPPORTING ROLE,47,1
Joan Lorring,False,F,1926,1945,ACTRESS IN A SUPPORTING ROLE,19,1
Joan Plowright,False,F,1929,1992,ACTRESS IN A SUPPORTING ROLE,63,1
Joanne Woodward,False,F,1930,1968,ACTRESS,38,4
Joanne Woodward,False,F,1930,1973,ACTRESS,43,4
Joanne Woodward,False,F,1930,1990,ACTRESS IN A LEADING ROLE,60,4
Joanne Woodward,True,F,1930,1957,ACTRESS,27,4
Joaquin Phoenix,False,M,1974,2000,ACTOR IN A SUPPORTING ROLE,26,4
Joaquin Phoenix,False,M,1974,2005,ACTOR IN A LEADING ROLE,31,4
Joaquin Phoenix,False,M,1974,2012,ACTOR IN A LEADING ROLE,38,4
Joaquin Phoenix,True,M,1974,2019,ACTOR IN A LEADING ROLE,45,4
Jodie Foster,False,F,1962,1976,ACTRESS IN A SUPPORTING ROLE,14,4
Jodie Foster,False,F,1962,1994,ACTRESS IN A LEADING ROLE,32,4
Jodie Foster,True,F,1962,1988,ACTRESS IN A LEADING ROLE,26,4
Jodie Foster,True,F,1962,1991,ACTRESS IN A LEADING ROLE,29,4
Joe Mantell,False,M,1915,1955,ACTOR IN A SUPPORTING ROLE,40,1
Joe Pesci,False,M,1943,1980,ACTOR IN A SUPPORTING ROLE,37,3
Joe Pesci,False,M,1943,2019,ACTOR IN A SUPPORTING ROLE,76,3
Joe Pesci,True,M,1943,1990,ACTOR IN A SUPPORTING ROLE,47,3
Joel Grey,True,M,1932,1972,ACTOR IN A SUPPORTING ROLE,40,1
John C. Reilly,False,M,1965,2002,ACTOR IN A SUPPORTING ROLE,37,1
John Cassavetes,False,M,1929,1967,ACTOR IN A SUPPORTING ROLE,38,1
John Dall,False,M,1920,1945,ACTOR IN A SUPPORTING ROLE,25,1
John Garfield,False,M,1913,1938,ACTOR IN A SUPPORTING ROLE,25,2
John Garfield,False,M,1913,1947,ACTOR,34,2
John Gielgud,False,M,1904,1964,ACTOR IN A SUPPORTING ROLE,60,2
John Gielgud,True,M,1904,1981,ACTOR IN A SUPPORTING ROLE,77,2
John Hawkes,False,M,1959,2010,ACTOR IN A SUPPORTING ROLE,51,1
John Houseman,True,M,1902,1973,ACTOR IN A SUPPORTING ROLE,71,1
John Hurt,False,M,1940,1978,ACTOR IN A SUPPORTING ROLE,38,2
John Hurt,False,M,1940,1980,ACTOR IN A LEADING ROLE,40,2
John Huston,False,M,1906,1963,ACTOR IN A SUPPORTING ROLE,57,1
John Ireland,False,M,1942,1949,ACTOR IN A SUPPORTING ROLE,7,1
John Lithgow,False,M,1945,1982,ACTOR IN A SUPPORTING ROLE,37,2
John Lithgow,False,M,1945,1983,ACTOR IN A SUPPORTING ROLE,38,2
John Malkovich,False,M,1953,1984,ACTOR IN A SUPPORTING ROLE,31,2
John Malkovich,False,M,1953,1993,ACTOR IN A SUPPORTING ROLE,40,2
John Marley,False,M,1907,1970,ACTOR IN A SUPPORTING ROLE,63,1
John Mills,True,M,1908,1970,ACTOR IN A SUPPORTING ROLE,62,1
John Travolta,False,M,1954,1977,ACTOR IN A LEADING ROLE,23,2
John Travolta,False,M,1954,1994,ACTOR IN A LEADING ROLE,40,2
John Wayne,False,M,1907,1949,ACTOR,42,2
John Wayne,True,M,1907,1969,ACTOR,62,2
Johnny Depp,False,M,1963,2003,ACTOR IN A LEADING ROLE,40,3
Johnny Depp,False,M,1963,2004,ACTOR IN A LEADING ROLE,41,3
Johnny Depp,False,M,1963,2007,ACTOR IN A LEADING ROLE,44,3
Jon Voight,False,M,1938,1969,ACTOR,31,4
Jon Voight,False,M,1938,1985,ACTOR IN A LEADING ROLE,47,4
Jon Voight,False,M,1938,2001,ACTOR IN A SUPPORTING ROLE,63,4
Jon Voight,True,M,1938,1978,ACTOR IN A LEADING ROLE,40,4
Jonah Hill,False,M,1983,2011,ACTOR IN A SUPPORTING ROLE,28,2
Jonah Hill,False,M,1983,2013,ACTOR IN A SUPPORTING ROLE,30,2
Jonathan Pryce,False,M,1947,2019,ACTOR IN A LEADING ROLE,72,1
Joseph Schildkraut,True,M,1896,1937,ACTOR IN A SUPPORTING ROLE,41,1
Josephine Hull,True,F,1877,1950,ACTRESS IN A SUPPORTING ROLE,73,1
Josh Brolin,False,M,1968,2008,ACTOR IN A SUPPORTING ROLE,40,1
José Ferrer,False,M,1912,1948,ACTOR IN A SUPPORTING ROLE,36,3
José Ferrer,False,M,1912,1952,ACTOR,40,3
José Ferrer,True,M,1912,1950,ACTOR,38,3
Joyce Redman,False,F,1915,1963,ACTRESS IN A SUPPORTING ROLE,48,2
Joyce Redman,False,F,1915,1965,ACTRESS IN A SUPPORTING ROLE,50,2
Juanita Moore,False,F,1914,1959,ACTRESS IN A SUPPORTING ROLE,45,1
Judd Hirsch,False,M,1935,1980,ACTOR IN A SUPPORTING ROLE,45,1
Jude Law,False,M,1972,1999,ACTOR IN A SUPPORTING ROLE,27,2
Jude Law,False,M,1972,2003,ACTOR IN A LEADING ROLE,31,2
Judi Dench,False,F,1934,1997,ACTRESS IN A LEADING ROLE,63,7
Judi Dench,False,F,1934,2000,ACTRESS IN A SUPPORTING ROLE,66,7
Judi Dench,False,F,1934,2001,ACTRESS IN A LEADING ROLE,67,7
Judi Dench,False,F,1934,2005,ACTRESS IN A LEADING ROLE,71,7
Judi Dench,False,F,1934,2006,ACTRESS IN A LEADING ROLE,72,7
Judi Dench,False,F,1934,2013,ACTRESS IN A LEADING ROLE,79,7
Judi Dench,True,F,1934,1998,ACTRESS IN A SUPPORTING ROLE,64,7
Judith Anderson,False,F,1897,1940,ACTRESS IN A SUPPORTING ROLE,43,1
Judy Davis,False,F,1955,1984,ACTRESS IN A LEADING ROLE,29,2
Judy Davis,False,F,1955,1992,ACTRESS IN A SUPPORTING ROLE,37,2
Judy Garland,False,F,1922,1954,ACTRESS,32,2
Judy Garland,False,F,1922,1961,ACTRESS IN A SUPPORTING ROLE,39,2
Judy Holliday,True,F,1921,1950,ACTRESS,29,1
Julia Roberts,False,F,1967,1989,ACTRESS IN A SUPPORTING ROLE,22,4
Julia Roberts,False,F,1967,1990,ACTRESS IN A LEADING ROLE,23,4
Julia Roberts,False,F,1967,2013,ACTRESS IN A SUPPORTING ROLE,46,4
Julia Roberts,True,F,1967,2000,ACTRESS IN A LEADING ROLE,33,4
Julianne Moore,False,F,1960,1997,ACTRESS IN A SUPPORTING ROLE,37,5
Julianne Moore,False,F,1960,1999,ACTRESS IN A LEADING ROLE,39,5
Julianne Moore,False,F,1960,2002,ACTRESS IN A LEADING ROLE,42,5
Julianne Moore,False,F,1960,2002,ACTRESS IN A SUPPORTING ROLE,42,5
Julianne Moore,True,F,1960,2014,ACTRESS IN A LEADING ROLE,54,5
Julie Andrews,False,F,1935,1965,ACTRESS,30,3
Julie Andrews,False,F,1935,1982,ACTRESS IN A LEADING ROLE,47,3
Julie Andrews,True,F,1935,1964,ACTRESS,29,3
Julie Christie,False,F,1940,1971,ACTRESS,31,4
Julie Christie,False,F,1940,1997,ACTRESS IN A LEADING ROLE,57,4
Julie Christie,False,F,1940,2007,ACTRESS IN A LEADING ROLE,67,4
Julie Christie,True,F,1940,1965,ACTRESS,25,4
Julie Harris,False,F,1925,1952,ACTRESS,27,1
Julie Walters,False,F,1950,1983,ACTRESS IN A LEADING ROLE,33,2
Julie Walters,False,F,1950,2000,ACTRESS IN A SUPPORTING ROLE,50,2
Juliette Binoche,False,F,1964,2000,ACTRESS IN A LEADING ROLE,36,2
Juliette Binoche,True,F,1964,1996,ACTRESS IN A SUPPORTING ROLE,32,2
Juliette Lewis,False,F,1973,1991,ACTRESS IN A SUPPORTING ROLE,18,1
June Squibb,False,F,1929,2013,ACTRESS IN A SUPPORTING ROLE,84,1
Justin Henry,False,M,1971,1979,ACTOR IN A SUPPORTING ROLE,8,1
Karen Black,False,F,1939,1970,ACTRESS IN A SUPPORTING ROLE,31,1
Karl Malden,False,M,1912,1954,ACTOR IN A SUPPORTING ROLE,42,2
Karl Malden,True,M,1912,1951,ACTOR IN A SUPPORTING ROLE,39,2
Kate Hudson,False,F,1979,2000,ACTRESS IN A SUPPORTING ROLE,21,1
Kate Nelligan,False,F,1950,1991,ACTRESS IN A SUPPORTING ROLE,41,1
Kate Winslet,False,F,1975,1995,ACTRESS IN A SUPPORTING ROLE,20,7
Kate Winslet,False,F,1975,1997,ACTRESS IN A LEADING ROLE,22,7
Kate Winslet,False,F,1975,2001,ACTRESS IN A SUPPORTING ROLE,26,7
Kate Winslet,False,F,1975,2004,ACTRESS IN A LEADING ROLE,29,7
Kate Winslet,False,F,1975,2006,ACTRESS IN A LEADING ROLE,31,7
Kate Winslet,False,F,1975,2015,ACTRESS IN A SUPPORTING ROLE,40,7
Kate Winslet,True,F,1975,2008,ACTRESS IN A LEADING ROLE,33,7
Katharine Hepburn,False,F,1907,1935,ACTRESS,28,12
Katharine Hepburn,False,F,1907,1940,ACTRESS,33,12
Katharine Hepburn,False,F,1907,1942,ACTRESS,35,12
Katharine Hepburn,False,F,1907,1951,ACTRESS,44,12
Katharine Hepburn,False,F,1907,1955,ACTRESS,48,12
Katharine Hepburn,False,F,1907,1956,ACTRESS,49,12
Katharine Hepburn,False,F,1907,1959,ACTRESS,52,12
Katharine Hepburn,False,F,1907,1962,ACTRESS,55,12
Katharine Hepburn,True,F,1907,1932,ACTRESS,25,12
Katharine Hepburn,True,F,1907,1967,ACTRESS,60,12
Katharine Hepburn,True,F,1907,1968,ACTRESS,61,12
Katharine Hepburn,True,F,1907,1981,ACTRESS IN A LEADING ROLE,74,12
Katharine Ross,False,F,1940,1967,ACTRESS IN A SUPPORTING ROLE,27,1
Kathleen Quinlan,False,F,1954,1995,ACTRESS IN A SUPPORTING ROLE,41,1
Kathleen Turner,False,F,1954,1986,ACTRESS IN A LEADING ROLE,32,1
Kathy Bates,False,F,1948,1998,ACTRESS IN A SUPPORTING ROLE,50,4
Kathy Bates,False,F,1948,2002,ACTRESS IN A SUPPORTING ROLE,54,4
Kathy Bates,False,F,1948,2019,ACTRESS IN A SUPPORTING ROLE,71,4
Kathy Bates,True,F,1948,1990,ACTRESS IN A LEADING ROLE,42,4
Katina Paxinou,True,F,1900,1943,ACTRESS IN A SUPPORTING ROLE,43,1
Katy Jurado,False,F,1924,1954,ACTRESS IN A SUPPORTING ROLE,30,1
Kay Medford,False,F,1919,1968,ACTRESS IN A SUPPORTING ROLE,49,1
Keira Knightley,False,F,1985,2005,ACTRESS IN A LEADING ROLE,20,2
Keira Knightley,False,F,1985,2014,ACTRESS IN A SUPPORTING ROLE,29,2
Keisha Castle-Hughes,False,F,1990,2003,ACTRESS IN A LEADING ROLE,13,1
Ken Watanabe,False,M,1959,2003,ACTOR IN A SUPPORTING ROLE,44,1
Kenneth Branagh,False,M,1960,1989,ACTOR IN A LEADING ROLE,29,2
Kenneth Branagh,False,M,1960,2011,ACTOR IN A SUPPORTING ROLE,51,2
Kevin Costner,False,M,1955,1990,ACTOR IN A LEADING ROLE,35,1
Kevin Kline,True,M,1947,1988,ACTOR IN A SUPPORTING ROLE,41,1
Kevin McCarthy,False,M,1914,1951,ACTOR IN A SUPPORTING ROLE,37,1
Kevin Spacey,True,M,1959,1995,ACTOR IN A SUPPORTING ROLE,36,2
Kevin Spacey,True,M,1959,1999,ACTOR IN A LEADING ROLE,40,2
Kim Basinger,True,F,1953,1997,ACTRESS IN A SUPPORTING ROLE,44,1
Kim Hunter,True,F,1922,1951,ACTRESS IN A SUPPORTING ROLE,29,1
Kim Stanley,False,F,1925,1964,ACTRESS,39,2
Kim Stanley,False,F,1925,1982,ACTRESS IN A SUPPORTING ROLE,57,2
Kirk Douglas,False,M,1916,1949,ACTOR,33,3
Kirk Douglas,False,M,1916,1952,ACTOR,36,3
Kirk Douglas,False,M,1916,1956,ACTOR,40,3
Klaus Maria Brandauer,False,M,1943,1985,ACTOR IN A SUPPORTING ROLE,42,1
Kristin Scott Thomas,False,F,1960,1996,ACTRESS IN A LEADING ROLE,36,1
Lady Gaga,False,F,1986,2018,ACTRESS IN A LEADING ROLE,32,1
Lana Turner,False,F,1921,1957,ACTRESS,36,1
Larry Parks,False,M,1914,1946,ACTOR,32,1
Laura Dern,False,F,1967,1991,ACTRESS IN A LEADING ROLE,24,3
Laura Dern,False,F,1967,2014,ACTRESS IN A SUPPORTING ROLE,47,3
Laura Dern,True,F,1967,2019,ACTRESS IN A SUPPORTING ROLE,52,3
Laura Linney,False,F,1964,2000,ACTRESS IN A LEADING ROLE,36,3
Laura Linney,False,F,1964,2004,ACTRESS IN A SUPPORTING ROLE,40,3
Laura Linney,False,F,1964,2007,ACTRESS IN A LEADING ROLE,43,3
Lauren Bacall,False,F,1924,1996,ACTRESS IN A SUPPORTING ROLE,72,1
Laurence Fishburne,False,M,1961,1993,ACTOR IN A LEADING ROLE,32,1
Laurence Harvey,False,M,1928,1959,ACTOR,31,1
Laurence Olivier,False,M,1907,1939,ACTOR,32,9
Laurence Olivier,False,M,1907,1940,ACTOR,33,9
Laurence Olivier,False,M,1907,1946,ACTOR,39,9
Laurence Olivier,False,M,1907,1956,ACTOR,49,9
Laurence Olivier,False,M,1907,1960,ACTOR,53,9
Laurence Olivier,False,M,1907,1965,ACTOR,58,9
Laurence Olivier,False,M,1907,1972,ACTOR,65,9
Laurence Olivier,False,M,1907,1976,ACTOR IN A SUPPORTING ROLE,69,9
Laurence Olivier,False,M,1907,1978,ACTOR IN A LEADING ROLE,71,9
Laurence Olivier,True,M,1907,1948,ACTOR,41,9
Laurie Metcalf,False,F,1955,2017,ACTRESS IN A SUPPORTING ROLE,62,1
Lawrence Tibbett,False,M,1896,1929,ACTOR,33,1
Lee Grant,False,F,1925,1951,ACTRESS IN A SUPPORTING ROLE,26,4
Lee Grant,False,F,1925,1970,ACTRESS IN A SUPPORTING ROLE,45,4
Lee Grant,False,F,1925,1976,ACTRESS IN A SUPPORTING ROLE,51,4
Lee Grant,True,F,1925,1975,ACTRESS IN A SUPPORTING ROLE,50,4
Lee J. Cobb,False,M,1911,1954,ACTOR IN A SUPPORTING ROLE,43,2
Lee J. Cobb,False,M,1911,1958,ACTOR IN A SUPPORTING ROLE,47,2
Lee Marvin,True,M,1924,1965,ACTOR,41,1
Lee Remick,False,F,1935,1962,ACTRESS,27,1
Lee Strasberg,False,M,1901,1974,ACTOR IN A SUPPORTING ROLE,73,1
Lee Tracy,False,M,1898,1964,ACTOR IN A SUPPORTING ROLE,66,1
Lena Olin,False,F,1955,1989,ACTRESS IN A SUPPORTING ROLE,34,1
Leo Genn,False,M,1905,1951,ACTOR IN A SUPPORTING ROLE,46,1
Leonard Frey,False,M,1938,1971,ACTOR IN A SUPPORTING ROLE,33,1
Leonardo DiCaprio,False,M,1974,1993,ACTOR IN A SUPPORTING ROLE,19,6
Leonardo DiCaprio,False,M,1974,2004,ACTOR IN A LEADING ROLE,30,6
Leonardo DiCaprio,False,M,1974,2006,ACTOR IN A LEADING ROLE,32,6
Leonardo DiCaprio,False,M,1974,2013,ACTOR IN A LEADING ROLE,39,6
Leonardo DiCaprio,False,M,1974,2019,ACTOR IN A LEADING ROLE,45,6
Leonardo DiCaprio,True,M,1974,2015,ACTOR IN A LEADING ROLE,41,6
Lesley Ann Warren,False,F,1946,1982,ACTRESS IN A SUPPORTING ROLE,36,1
Lesley Manville,False,F,1956,2017,ACTRESS IN A SUPPORTING ROLE,61,1
Leslie Browne,False,F,1957,1977,ACTRESS IN A SUPPORTING ROLE,20,1
Leslie Caron,False,F,1931,1953,ACTRESS,22,2
Leslie Caron,False,F,1931,1963,ACTRESS,32,2
Leslie Howard,False,M,1893,1932,ACTOR,39,2
Leslie Howard,False,M,1893,1938,ACTOR,45,2
Lew Ayres,False,M,1908,1948,ACTOR,40,1
Lewis Stone,False,M,1879,1928,ACTOR,49,1
Liam Neeson,False,M,1952,1993,ACTOR IN A LEADING ROLE,41,1
Lila Kedrova,True,F,1918,1964,ACTRESS IN A SUPPORTING ROLE,46,1
Lilia Skala,False,F,1896,1963,ACTRESS IN A SUPPORTING ROLE,67,1
Lillian Gish,False,F,1893,1946,ACTRESS IN A SUPPORTING ROLE,53,1
Lily Tomlin,False,F,1939,1975,ACTRESS IN A SUPPORTING ROLE,36,1
Linda Blair,False,F,1959,1973,ACTRESS IN A SUPPORTING ROLE,14,1
Linda Hunt,True,F,1945,1983,ACTRESS IN A SUPPORTING ROLE,38,1
Lindsay Crouse,False,F,1948,1984,ACTRESS IN A SUPPORTING ROLE,36,1
Lionel Barrymore,True,M,1878,1930,ACTOR,52,1
Liv Ullmann,False,F,1938,1972,ACTRESS,34,2
Liv Ullmann,False,F,1938,1976,ACTRESS IN A LEADING ROLE,38,2
Liza Minnelli,False,F,1946,1969,ACTRESS,23,2
Liza Minnelli,True,F,1946,1972,ACTRESS,26,2
Loretta Young,False,F,1913,1949,ACTRESS,36,2
Loretta Young,True,F,1913,1947,ACTRESS,34,2
Lorraine Bracco,False,F,1954,1990,ACTRESS IN A SUPPORTING ROLE,36,1
Lotte Lenya,False,F,1898,1961,ACTRESS IN A SUPPORTING ROLE,63,1
Louis Calhern,False,M,1895,1950,ACTOR,55,1
Louise Dresser,False,F,1878,1927,ACTRESS,49,1
Louise Fletcher,True,F,1934,1975,ACTRESS,41,1
Lucas Hedges,False,M,1996,2016,ACTOR IN A SUPPORTING ROLE,20,1
Lucile Watson,False,F,1879,1943,ACTRESS IN A SUPPORTING ROLE,64,1
Luise Rainer,True,F,1910,1936,ACTRESS,26,2
Luise Rainer,True,F,1910,1937,ACTRESS,27,2
Lupita Nyong'o,True,F,1983,2013,ACTRESS IN A SUPPORTING ROLE,30,1
Lynn Carlin,False,F,1938,1968,ACTRESS IN A SUPPORTING ROLE,30,1
Lynn Fontanne,False,F,1887,1931,ACTRESS,44,1
Lynn Redgrave,False,F,1943,1966,ACTRESS,23,2
Lynn Redgrave,False,F,1943,1998,ACTRESS IN A SUPPORTING ROLE,55,2
Madeline Kahn,False,F,1942,1973,ACTRESS IN A SUPPORTING ROLE,31,2
Madeline Kahn,False,F,1942,1974,ACTRESS IN A SUPPORTING ROLE,32,2
Maggie Gyllenhaal,False,F,1977,2009,ACTRESS IN A SUPPORTING ROLE,32,1
Maggie McNamara,False,F,1928,1953,ACTRESS,25,1
Maggie Smith,False,F,1934,1965,ACTRESS IN A SUPPORTING ROLE,31,6
Maggie Smith,False,F,1934,1972,ACTRESS,38,6
Maggie Smith,False,F,1934,1986,ACTRESS IN A SUPPORTING ROLE,52,6
Maggie Smith,False,F,1934,2001,ACTRESS IN A SUPPORTING ROLE,67,6
Maggie Smith,True,F,1934,1969,ACTRESS,35,6
Maggie Smith,True,F,1934,1978,ACTRESS IN A SUPPORTING ROLE,44,6
Mahershala Ali,True,M,1974,2016,ACTOR IN A SUPPORTING ROLE,42,2
Mahershala Ali,True,M,1974,2018,ACTOR IN A SUPPORTING ROLE,44,2
Mako,False,M,1933,1966,ACTOR IN A SUPPORTING ROLE,33,1
Marcello Mastroianni,False,M,1924,1962,ACTOR,38,3
Marcello Mastroianni,False,M,1924,1977,ACTOR IN A LEADING ROLE,53,3
Marcello Mastroianni,False,M,1924,1987,ACTOR IN A LEADING ROLE,63,3
Marcia Gay Harden,False,F,1959,2003,ACTRESS IN A SUPPORTING ROLE,44,2
Marcia Gay Harden,True,F,1959,2000,ACTRESS IN A SUPPORTING ROLE,41,2
Mare Winningham,False,F,1959,1995,ACTRESS IN A SUPPORTING ROLE,36,1
Margaret Avery,False,F,1944,1985,ACTRESS IN A SUPPORTING ROLE,41,1
Margaret Leighton,False,F,1922,1971,ACTRESS IN A SUPPORTING ROLE,49,1
Margaret Rutherford,True,F,1892,1963,ACTRESS IN A SUPPORTING ROLE,71,1
Margaret Sullavan,False,F,1909,1938,ACTRESS,29,1
Margaret Wycherly,False,F,1881,1941,ACTRESS IN A SUPPORTING ROLE,60,1
Margot Robbie,False,F,1990,2017,ACTRESS IN A LEADING ROLE,27,2
Margot Robbie,False,F,1990,2019,ACTRESS IN A SUPPORTING ROLE,29,2
Maria Ouspenskaya,False,F,1876,1936,ACTRESS IN A SUPPORTING ROLE,60,2
Maria Ouspenskaya,False,F,1876,1939,ACTRESS IN A SUPPORTING ROLE,63,2
Marianne Jean-Baptiste,False,F,1967,1996,ACTRESS IN A SUPPORTING ROLE,29,1
Marie Dressler,False,F,1868,1931,ACTRESS,63,2
Marie Dressler,True,F,1868,1930,ACTRESS,62,2
Marie-Christine Barrault,False,F,1944,1976,ACTRESS IN A LEADING ROLE,32,1
Mariel Hemingway,False,F,1961,1979,ACTRESS IN A SUPPORTING ROLE,18,1
Marina de Tavira,False,F,1974,2018,ACTRESS IN A SUPPORTING ROLE,44,1
Marion Cotillard,False,F,1975,2014,ACTRESS IN A LEADING ROLE,39,2
Marion Cotillard,True,F,1975,2007,ACTRESS IN A LEADING ROLE,32,2
Marisa Pavan,False,F,1932,1955,ACTRESS IN A SUPPORTING ROLE,23,1
Marisa Tomei,False,F,1964,2001,ACTRESS IN A SUPPORTING ROLE,37,3
Marisa Tomei,False,F,1964,2008,ACTRESS IN A SUPPORTING ROLE,44,3
Marisa Tomei,True,F,1964,1992,ACTRESS IN A SUPPORTING ROLE,28,3
Marjorie Main,False,F,1890,1947,ACTRESS IN A SUPPORTING ROLE,57,1
Marjorie Rambeau,False,F,1889,1940,ACTRESS IN A SUPPORTING ROLE,51,2
Marjorie Rambeau,False,F,1889,1953,ACTRESS IN A SUPPORTING ROLE,64,2
Mark Ruffalo,False,M,1967,2010,ACTOR IN A SUPPORTING ROLE,43,3
Mark Ruffalo,False,M,1967,2014,ACTOR IN A SUPPORTING ROLE,47,3
Mark Ruffalo,False,M,1967,2015,ACTOR IN A SUPPORTING ROLE,48,3
Mark Rylance,True,M,1960,2015,ACTOR IN A SUPPORTING ROLE,55,1
Mark Wahlberg,False,M,1971,2006,ACTOR IN A SUPPORTING ROLE,35,1
Marlee Matlin,True,F,1965,1986,ACTRESS IN A LEADING ROLE,21,1
Marlene Dietrich,False,F,1901,1930,ACTRESS,29,1
Marlon Brando,False,M,1924,1951,ACTOR,27,8
Marlon Brando,False,M,1924,1952,ACTOR,28,8
Marlon Brando,False,M,1924,1953,ACTOR,29,8
Marlon Brando,False,M,1924,1957,ACTOR,33,8
Marlon Brando,False,M,1924,1973,ACTOR,49,8
Marlon Brando,False,M,1924,1989,ACTOR IN A SUPPORTING ROLE,65,8
Marlon Brando,True,M,1924,1954,ACTOR,30,8
Marlon Brando,True,M,1924,1972,ACTOR,48,8
Marsha Mason,False,F,1942,1973,ACTRESS,31,4
Marsha Mason,False,F,1942,1977,ACTRESS IN A LEADING ROLE,35,4
Marsha Mason,False,F,1942,1979,ACTRESS IN A LEADING ROLE,37,4
Marsha Mason,False,F,1942,1981,ACTRESS IN A LEADING ROLE,39,4
Martha Hyer,False,F,1924,1958,ACTRESS IN A SUPPORTING ROLE,34,1
Martha Scott,False,F,1912,1940,ACTRESS,28,1
Martin Balsam,True,M,1919,1965,ACTOR IN A SUPPORTING ROLE,46,1
Martin Landau,False,M,1928,1988,ACTOR IN A SUPPORTING ROLE,60,3
Martin Landau,False,M,1928,1989,ACTOR IN A SUPPORTING ROLE,61,3
Martin Landau,True,M,1928,1994,ACTOR IN A SUPPORTING ROLE,66,3
Mary Astor,True,F,1906,1941,ACTRESS IN A SUPPORTING ROLE,35,1
Mary Badham,False,F,1952,1962,ACTRESS IN A SUPPORTING ROLE,10,1
Mary Elizabeth Mastrantonio,False,F,1958,1986,ACTRESS IN A SUPPORTING ROLE,28,1
Mary J. Blige,False,F,1971,2017,ACTRESS IN A SUPPORTING ROLE,46,1
Mary McDonnell,False,F,1952,1990,ACTRESS IN A SUPPORTING ROLE,38,2
Mary McDonnell,False,F,1952,1992,ACTRESS IN A LEADING ROLE,40,2
Mary Pickford,True,F,1892,1928,ACTRESS,36,1
Mary Steenburgen,True,F,1953,1980,ACTRESS IN A SUPPORTING ROLE,27,1
Mary Tyler Moore,False,F,1936,1980,ACTRESS IN A LEADING ROLE,44,1
Mary Ure,False,F,1933,1960,ACTRESS IN A SUPPORTING ROLE,27,1
Massimo Troisi,False,M,1953,1995,ACTOR IN A LEADING ROLE,42,1
Matt Damon,False,M,1970,1997,ACTOR IN A LEADING ROLE,27,3
Matt Damon,False,M,1970,2009,ACTOR IN A SUPPORTING ROLE,39,3
Matt Damon,False,M,1970,2015,ACTOR IN A LEADING ROLE,45,3
Matt Dillon,False,M,1964,2005,ACTOR IN A SUPPORTING ROLE,41,1
Matthew McConaughey,True,M,1969,2013,ACTOR IN A LEADING ROLE,44,1
Maureen Stapleton,False,F,1925,1958,ACTRESS IN A SUPPORTING ROLE,33,4
Maureen Stapleton,False,F,1925,1970,ACTRESS IN A SUPPORTING ROLE,45,4
Maureen Stapleton,False,F,1925,1978,ACTRESS IN A SUPPORTING ROLE,53,4
Maureen Stapleton,True,F,1925,1981,ACTRESS IN A SUPPORTING ROLE,56,4
Maurice Chevalier,False,M,1888,1929,ACTOR,41,1
Max von Sydow,False,M,1929,1988,ACTOR IN A LEADING ROLE,59,2
Max von Sydow,False,M,1929,2011,ACTOR IN A SUPPORTING ROLE,82,2
Maximilian Schell,False,M,1930,1975,ACTOR,45,3
Maximilian Schell,False,M,1930,1977,ACTOR IN A SUPPORTING ROLE,47,3
Maximilian Schell,True,M,1930,1961,ACTOR,31,3
May Robson,False,F,1858,1932,ACTRESS,74,1
Meg Tilly,False,F,1960,1985,ACTRESS IN A SUPPORTING ROLE,25,1
Melanie Griffith,False,F,1957,1988,ACTRESS IN A LEADING ROLE,31,1
Melina Mercouri,False,F,1920,1960,ACTRESS,40,1
Melinda Dillon,False,F,1939,1977,ACTRESS IN A SUPPORTING ROLE,38,2
Melinda Dillon,False,F,1939,1981,ACTRESS IN A SUPPORTING ROLE,42,2
Melissa Leo,False,F,1960,2008,ACTRESS IN A LEADING ROLE,48,2
Melissa Leo,True,F,1960,2010,ACTRESS IN A SUPPORTING ROLE,50,2
Melissa McCarthy,False,F,1970,2011,ACTRESS IN A SUPPORTING ROLE,41,2
Melissa McCarthy,False,F,1970,2018,ACTRESS IN A LEADING ROLE,48,2
Melvyn Douglas,False,M,1901,1970,ACTOR,69,3
Melvyn Douglas,True,M,1901,1963,ACTOR IN A SUPPORTING ROLE,62,3
Melvyn Douglas,True,M,1901,1979,ACTOR IN A SUPPORTING ROLE,78,3
Mercedes McCambridge,False,F,1916,1956,ACTRESS IN A SUPPORTING ROLE,40,2
Mercedes McCambridge,True,F,1916,1949,ACTRESS IN A SUPPORTING ROLE,33,2
Mercedes Ruehl,True,F,1948,1991,ACTRESS IN A SUPPORTING ROLE,43,1
Merle Oberon,False,F,1911,1935,ACTRESS,24,1
Meryl Streep,False,F,1949,1978,ACTRESS IN A SUPPORTING ROLE,29,21
Meryl Streep,False,F,1949,1981,ACTRESS IN A LEADING ROLE,32,21
Meryl Streep,False,F,1949,1983,ACTRESS IN A LEADING ROLE,34,21
Meryl Streep,False,F,1949,1985,ACTRESS IN A LEADING ROLE,36,21
Meryl Streep,False,F,1949,1987,ACTRESS IN A LEADING ROLE,38,21
Meryl Streep,False,F,1949,1988,ACTRESS IN A LEADING ROLE,39,21
Meryl Streep,False,F,1949,1990,ACTRESS IN A LEADING ROLE,41,21
Meryl Streep,False,F,1949,1995,ACTRESS IN A LEADING ROLE,46,21
Meryl Streep,False,F,1949,1998,ACTRESS IN A LEADING ROLE,49,21
Meryl Streep,False,F,1949,1999,ACTRESS IN A LEADING ROLE,50,21
Meryl Streep,False,F,1949,2002,ACTRESS IN A SUPPORTING ROLE,53,21
Meryl Streep,False,F,1949,2006,ACTRESS IN A LEADING ROLE,57,21
Meryl Streep,False,F,1949,2008,ACTRESS IN A LEADING ROLE,59,21
Meryl Streep,False,F,1949,2009,ACTRESS IN A LEADING ROLE,60,21
Meryl Streep,False,F,1949,2013,ACTRESS IN A LEADING ROLE,64,21
Meryl Streep,False,F,1949,2014,ACTRESS IN A SUPPORTING ROLE,65,21
Meryl Streep,False,F,1949,2016,ACTRESS IN A LEADING ROLE,67,21
Meryl Streep,False,F,1949,2017,ACTRESS IN A LEADING ROLE,68,21
Meryl Streep,True,F,1949,1979,ACTRESS IN A SUPPORTING ROLE,30,21
Meryl Streep,True,F,1949,1982,ACTRESS IN A LEADING ROLE,33,21
Meryl Streep,True,F,1949,2011,ACTRESS IN A LEADING ROLE,62,21
Michael Caine,False,M,1933,1966,ACTOR,33,6
Michael Caine,False,M,1933,1972,ACTOR,39,6
Michael Caine,False,M,1933,1983,ACTOR IN A LEADING ROLE,50,6
Michael Caine,False,M,1933,2002,ACTOR IN A LEADING ROLE,69,6
Michael Caine,True,M,1933,1986,ACTOR IN A SUPPORTING ROLE,53,6
Michael Caine,True,M,1933,1999,ACTOR IN A SUPPORTING ROLE,66,6
Michael Chekhov,False,M,1891,1945,ACTOR IN A SUPPORTING ROLE,54,1
Michael Clarke Duncan,False,M,1957,1999,ACTOR IN A SUPPORTING ROLE,42,1
Michael Douglas,True,M,1944,1987,ACTOR IN A LEADING ROLE,43,1
Michael Dunn,False,M,1934,1965,ACTOR IN A SUPPORTING ROLE,31,1
Michael Fassbender,False,M,1977,2013,ACTOR IN A SUPPORTING ROLE,36,2
Michael Fassbender,False,M,1977,2015,ACTOR IN A LEADING ROLE,38,2
Michael J. Pollard,False,M,1939,1967,ACTOR IN A SUPPORTING ROLE,28,1
Michael Keaton,False,M,1951,2014,ACTOR IN A LEADING ROLE,63,1
Michael Lerner,False,M,1941,1991,ACTOR IN A SUPPORTING ROLE,50,1
Michael O'Keefe,False,M,1955,1980,ACTOR IN A SUPPORTING ROLE,25,1
Michael Redgrave,False,M,1908,1947,ACTOR,39,1
Michael Shannon,False,M,1943,2008,ACTOR IN A SUPPORTING ROLE,65,2
Michael Shannon,False,M,1943,2016,ACTOR IN A SUPPORTING ROLE,73,2
Michael V. Gazzo,False,M,1923,1974,ACTOR IN A SUPPORTING ROLE,51,1
Michelle Pfeiffer,False,F,1958,1988,ACTRESS IN A SUPPORTING ROLE,30,3
Michelle Pfeiffer,False,F,1958,1989,ACTRESS IN A LEADING ROLE,31,3
Michelle Pfeiffer,False,F,1958,1992,ACTRESS IN A LEADING ROLE,34,3
Michelle Williams,False,F,1980,2005,ACTRESS IN A SUPPORTING ROLE,25,4
Michelle Williams,False,F,1980,2010,ACTRESS IN A LEADING ROLE,30,4
Michelle Williams,False,F,1980,2011,ACTRESS IN A LEADING ROLE,31,4
Michelle Williams,False,F,1980,2016,ACTRESS IN A SUPPORTING ROLE,36,4
Mickey Rooney,False,M,1920,1939,ACTOR,19,4
Mickey Rooney,False,M,1920,1943,ACTOR,23,4
Mickey Rooney,False,M,1920,1956,ACTOR IN A SUPPORTING ROLE,36,4
Mickey Rooney,False,M,1920,1979,ACTOR IN A SUPPORTING ROLE,59,4
Mickey Rourke,False,M,1952,2008,ACTOR IN A LEADING ROLE,56,1
Mikhail Baryshnikov,False,M,1948,1977,ACTOR IN A SUPPORTING ROLE,29,1
Mildred Dunnock,False,F,1901,1951,ACTRESS IN A SUPPORTING ROLE,50,2
Mildred Dunnock,False,F,1901,1956,ACTRESS IN A SUPPORTING ROLE,55,2
Mildred Natwick,False,F,1905,1967,ACTRESS IN A SUPPORTING ROLE,62,1
Miliza Korjus,False,F,1909,1938,ACTRESS IN A SUPPORTING ROLE,29,1
Minnie Driver,False,F,1970,1997,ACTRESS IN A SUPPORTING ROLE,27,1
Mira Sorvino,True,F,1967,1995,ACTRESS IN A SUPPORTING ROLE,28,1
Miranda Richardson,False,F,1958,1992,ACTRESS IN A SUPPORTING ROLE,34,2
Miranda Richardson,False,F,1958,1994,ACTRESS IN A LEADING ROLE,36,2
Miriam Hopkins,False,F,1902,1935,ACTRESS,33,1
Mischa Auer,False,M,1905,1936,ACTOR IN A SUPPORTING ROLE,31,1
Miyoshi Umeki,True,F,1929,1957,ACTRESS IN A SUPPORTING ROLE,28,1
Mo'Nique,True,F,1967,2009,ACTRESS IN A SUPPORTING ROLE,42,1
Montgomery Clift,False,M,1920,1948,ACTOR,28,4
Montgomery Clift,False,M,1920,1951,ACTOR,31,4
Montgomery Clift,False,M,1920,1953,ACTOR,33,4
Montgomery Clift,False,M,1920,1961,ACTOR IN A SUPPORTING ROLE,41,4
Monty Woolley,False,M,1888,1942,ACTOR,54,2
Monty Woolley,False,M,1888,1944,ACTOR IN A SUPPORTING ROLE,56,2
Morgan Freeman,False,M,1937,1987,ACTOR IN A SUPPORTING ROLE,50,5
Morgan Freeman,False,M,1937,1989,ACTOR IN A LEADING ROLE,52,5
Morgan Freeman,False,M,1937,1994,ACTOR IN A LEADING ROLE,57,5
Morgan Freeman,False,M,1937,2009,ACTOR IN A LEADING ROLE,72,5
Morgan Freeman,True,M,1937,2004,ACTOR IN A SUPPORTING ROLE,67,5
Nancy Carroll,False,F,1903,1929,ACTRESS,26,1
Nancy Kelly,False,F,1921,1956,ACTRESS,35,1
Nancy Olson,False,F,1928,1950,ACTRESS IN A SUPPORTING ROLE,22,1
Naomi Watts,False,F,1968,2003,ACTRESS IN A LEADING ROLE,35,2
Naomi Watts,False,F,1968,2012,ACTRESS IN A LEADING ROLE,44,2
Naomie Harris,False,F,1976,2016,ACTRESS IN A SUPPORTING ROLE,40,1
Natalie Portman,False,F,1981,2004,ACTRESS IN A SUPPORTING ROLE,23,3
Natalie Portman,False,F,1981,2016,ACTRESS IN A LEADING ROLE,35,3
Natalie Portman,True,F,1981,2010,ACTRESS IN A LEADING ROLE,29,3
Natalie Wood,False,F,1938,1955,ACTRESS IN A SUPPORTING ROLE,17,3
Natalie Wood,False,F,1938,1961,ACTRESS,23,3
Natalie Wood,False,F,1938,1963,ACTRESS,25,3
Ned Beatty,False,M,1937,1976,ACTOR IN A SUPPORTING ROLE,39,1
Nick Adams,False,M,1931,1963,ACTOR IN A SUPPORTING ROLE,32,1
Nick Nolte,False,M,1941,1991,ACTOR IN A LEADING ROLE,50,3
Nick Nolte,False,M,1941,1998,ACTOR IN A LEADING ROLE,57,3
Nick Nolte,False,M,1941,2011,ACTOR IN A SUPPORTING ROLE,70,3
Nicolas Cage,False,M,1964,2002,ACTOR IN A LEADING ROLE,38,2
Nicolas Cage,True,M,1964,1995,ACTOR IN A LEADING ROLE,31,2
Nicole Kidman,False,F,1967,2001,ACTRESS IN A LEADING ROLE,34,4
Nicole Kidman,False,F,1967,2010,ACTRESS IN A LEADING ROLE,43,4
Nicole Kidman,False,F,1967,2016,ACTRESS IN A SUPPORTING ROLE,49,4
Nicole Kidman,True,F,1967,2002,ACTRESS IN A LEADING ROLE,35,4
Nigel Hawthorne,False,M,1929,1994,ACTOR IN A LEADING ROLE,65,1
Nina Foch,False,F,1924,1954,ACTRESS IN A SUPPORTING ROLE,30,1
Norma Aleandro,False,F,1936,1987,ACTRESS IN A SUPPORTING ROLE,51,1
Norma Shearer,False,F,1902,1929,ACTRESS,27,6
Norma Shearer,False,F,1902,1930,ACTRESS,28,6
Norma Shearer,False,F,1902,1934,ACTRESS,32,6
Norma Shearer,False,F,1902,1936,ACTRESS,34,6
Norma Shearer,False,F,1902,1938,ACTRESS,36,6
Norma Shearer,True,F,1902,1929,ACTRESS,27,6
Octavia Spencer,False,F,1970,2016,ACTRESS IN A SUPPORTING ROLE,46,3
Octavia Spencer,False,F,1970,2017,ACTRESS IN A SUPPORTING ROLE,47,3
Octavia Spencer,True,F,1970,2011,ACTRESS IN A SUPPORTING ROLE,41,3
Olivia Colman,True,F,1974,2018,ACTRESS IN A LEADING ROLE,44,1
Olivia de Havilland,False,F,1916,1939,ACTRESS IN A SUPPORTING ROLE,23,5
Olivia de Havilland,False,F,1916,1941,ACTRESS,25,5
Olivia de Havilland,False,F,1916,1948,ACTRESS,32,5
Olivia de Havilland,True,F,1916,1946,ACTRESS,30,5
Olivia de Havilland,True,F,1916,1949,ACTRESS,33,5
Olympia Dukakis,True,F,1931,1987,ACTRESS IN A SUPPORTING ROLE,56,1
Omar Sharif,False,M,1932,1962,ACTOR IN A SUPPORTING ROLE,30,1
Oprah Winfrey,False,F,1954,1985,ACTRESS IN A SUPPORTING ROLE,31,1
Orson Welles,False,M,1915,1941,ACTOR,26,1
Oskar Werner,False,M,1922,1965,ACTOR,43,1
Patricia Arquette,True,F,1968,2014,ACTRESS IN A SUPPORTING ROLE,46,1
Patricia Clarkson,False,F,1959,2003,ACTRESS IN A SUPPORTING ROLE,44,1
Patricia Collinge,False,F,1892,1941,ACTRESS IN A SUPPORTING ROLE,49,1
Patricia Neal,False,F,1926,1968,ACTRESS,42,2
Patricia Neal,True,F,1926,1963,ACTRESS,37,2
Patty Duke,True,F,1946,1962,ACTRESS IN A SUPPORTING ROLE,16,1
Patty McCormack,False,F,1945,1956,ACTRESS IN A SUPPORTING ROLE,11,1
Paul Giamatti,False,M,1967,2005,ACTOR IN A SUPPORTING ROLE,38,1
Paul Lukas,True,M,1895,1943,ACTOR,48,1
Paul Muni,False,M,1895,1928,ACTOR,33,6
Paul Muni,False,M,1895,1932,ACTOR,37,6
Paul Muni,False,M,1895,1935,ACTOR,40,6
Paul Muni,False,M,1895,1937,ACTOR,42,6
Paul Muni,False,M,1895,1959,ACTOR,64,6
Paul Muni,True,M,1895,1936,ACTOR,41,6
Paul Newman,False,M,1925,1958,ACTOR,33,9
Paul Newman,False,M,1925,1961,ACTOR,36,9
Paul Newman,False,M,1925,1963,ACTOR,38,9
Paul Newman,False,M,1925,1967,ACTOR,42,9
Paul Newman,False,M,1925,1981,ACTOR IN A LEADING ROLE,56,9
Paul Newman,False,M,1925,1982,ACTOR IN A LEADING ROLE,57,9
Paul Newman,False,M,1925,1994,ACTOR IN A LEADING ROLE,69,9
Paul Newman,False,M,1925,2002,ACTOR IN A SUPPORTING ROLE,77,9
Paul Newman,True,M,1925,1986,ACTOR IN A LEADING ROLE,61,9
Paul Scofield,False,M,1922,1994,ACTOR IN A SUPPORTING ROLE,72,2
Paul Scofield,True,M,1922,1966,ACTOR,44,2
Paul Winfield,False,M,1939,1972,ACTOR,33,1
Paulette Goddard,False,F,1910,1943,ACTRESS IN A SUPPORTING ROLE,33,1
Pauline Collins,False,F,1940,1989,ACTRESS IN A LEADING ROLE,49,1
Peggy Ashcroft,True,F,1907,1984,ACTRESS IN A SUPPORTING ROLE,77,1
Peggy Cass,False,F,1924,1958,ACTRESS IN A SUPPORTING ROLE,34,1
Peggy Lee,False,F,1920,1955,ACTRESS IN A SUPPORTING ROLE,35,1
Peggy Wood,False,F,1892,1965,ACTRESS IN A SUPPORTING ROLE,73,1
Penelope Milford,False,F,1948,1978,ACTRESS IN A SUPPORTING ROLE,30,1
Penélope Cruz,False,F,1974,2006,ACTRESS IN A LEADING ROLE,32,3
Penélope Cruz,False,F,1974,2009,ACTRESS IN A SUPPORTING ROLE,35,3
Penélope Cruz,True,F,1974,2008,ACTRESS IN A SUPPORTING ROLE,34,3
Pete Postlethwaite,False,M,1946,1993,ACTOR IN A SUPPORTING ROLE,47,1
Peter Falk,False,M,1927,1960,ACTOR IN A SUPPORTING ROLE,33,2
Peter Falk,False,M,1927,1961,ACTOR IN A SUPPORTING ROLE,34,2
Peter Finch,False,M,1916,1971,ACTOR,55,2
Peter Finch,True,M,1916,1976,ACTOR IN A LEADING ROLE,60,2
Peter Firth,False,M,1953,1977,ACTOR IN A SUPPORTING ROLE,24,1
Peter Fonda,False,M,1940,1997,ACTOR IN A LEADING ROLE,57,1
Peter O'Toole,False,M,1932,1962,ACTOR,30,8
Peter O'Toole,False,M,1932,1964,ACTOR,32,8
Peter O'Toole,False,M,1932,1968,ACTOR,36,8
Peter O'Toole,False,M,1932,1969,ACTOR,37,8
Peter O'Toole,False,M,1932,1972,ACTOR,40,8
Peter O'Toole,False,M,1932,1980,ACTOR IN A LEADING ROLE,48,8
Peter O'Toole,False,M,1932,1982,ACTOR IN A LEADING ROLE,50,8
Peter O'Toole,False,M,1932,2006,ACTOR IN A LEADING ROLE,74,8
Peter Sellers,False,M,1925,1964,ACTOR,39,2
Peter Sellers,False,M,1925,1979,ACTOR IN A LEADING ROLE,54,2
Peter Ustinov,False,M,1921,1951,ACTOR IN A SUPPORTING ROLE,30,3
Peter Ustinov,True,M,1921,1960,ACTOR IN A SUPPORTING ROLE,39,3
Peter Ustinov,True,M,1921,1964,ACTOR IN A SUPPORTING ROLE,43,3
Philip Seymour Hoffman,False,M,1967,2007,ACTOR IN A SUPPORTING ROLE,40,4
Philip Seymour Hoffman,False,M,1967,2008,ACTOR IN A SUPPORTING ROLE,41,4
Philip Seymour Hoffman,False,M,1967,2012,ACTOR IN A SUPPORTING ROLE,45,4
Philip Seymour Hoffman,True,M,1967,2005,ACTOR IN A LEADING ROLE,38,4
Piper Laurie,False,F,1932,1961,ACTRESS,29,3
Piper Laurie,False,F,1932,1976,ACTRESS IN A SUPPORTING ROLE,44,3
Piper Laurie,False,F,1932,1986,ACTRESS IN A SUPPORTING ROLE,54,3
Queen Latifah,False,F,1970,2002,ACTRESS IN A SUPPORTING ROLE,32,1
Quinn Cummings,False,F,1967,1977,ACTRESS IN A SUPPORTING ROLE,10,1
Quvenzhané Wallis,False,F,2003,2012,ACTRESS IN A LEADING ROLE,9,1
Rachel Griffiths,False,F,1968,1998,ACTRESS IN A SUPPORTING ROLE,30,1
Rachel McAdams,False,F,1978,2015,ACTRESS IN A SUPPORTING ROLE,37,1
Rachel Roberts,False,F,1927,1963,ACTRESS,36,1
Rachel Weisz,False,F,1970,2018,ACTRESS IN A SUPPORTING ROLE,48,2
Rachel Weisz,True,F,1970,2005,ACTRESS IN A SUPPORTING ROLE,35,2
Ralph Bellamy,False,M,1904,1937,ACTOR IN A SUPPORTING ROLE,33,1
Ralph Fiennes,False,M,1962,1993,ACTOR IN A SUPPORTING ROLE,31,2
Ralph Fiennes,False,M,1962,1996,ACTOR IN A LEADING ROLE,34,2
Ralph Richardson,False,M,1902,1949,ACTOR IN A SUPPORTING ROLE,47,2
Ralph Richardson,False,M,1902,1984,ACTOR IN A SUPPORTING ROLE,82,2
Rami Malek,True,M,1981,2018,ACTOR IN A LEADING ROLE,37,1
Randy Quaid,False,M,1950,1973,ACTOR IN A SUPPORTING ROLE,23,1
Ray Milland,True,M,1907,1945,ACTOR,38,1
Raymond Massey,False,M,1896,1940,ACTOR,44,1
Red Buttons,True,M,1919,1957,ACTOR IN A SUPPORTING ROLE,38,1
Reese Witherspoon,False,F,1976,2014,ACTRESS IN A LEADING ROLE,38,2
Reese Witherspoon,True,F,1976,2005,ACTRESS IN A LEADING ROLE,29,2
Regina King,True,F,1971,2018,ACTRESS IN A SUPPORTING ROLE,47,1
Renée Zellweger,False,F,1969,2001,ACTRESS IN A LEADING ROLE,32,4
Renée Zellweger,False,F,1969,2002,ACTRESS IN A LEADING ROLE,33,4
Renée Zellweger,True,F,1969,2003,ACTRESS IN A SUPPORTING ROLE,34,4
Renée Zellweger,True,F,1969,2019,ACTRESS IN A LEADING ROLE,50,4
Rex Harrison,False,M,1908,1963,ACTOR,55,2
Rex Harrison,True,M,1908,1964,ACTOR,56,2
Richard Barthelmess,False,M,1895,1927,ACTOR,32,1
Richard Burton,False,M,1925,1952,ACTOR IN A SUPPORTING ROLE,27,7
Richard Burton,False,M,1925,1953,ACTOR,28,7
Richard Burton,False,M,1925,1964,ACTOR,39,7
Richard Burton,False,M,1925,1965,ACTOR,40,7
Richard Burton,False,M,1925,1966,ACTOR,41,7
Richard Burton,False,M,1925,1969,ACTOR,44,7
Richard Burton,False,M,1925,1977,ACTOR IN A LEADING ROLE,52,7
Richard Castellano,False,M,1933,1970,ACTOR IN A SUPPORTING ROLE,37,1
Richard Dix,False,M,1893,1930,ACTOR,37,1
Richard Dreyfuss,False,M,1947,1995,ACTOR IN A LEADING ROLE,48,2
Richard Dreyfuss,True,M,1947,1977,ACTOR IN A LEADING ROLE,30,2
Richard E. Grant,False,M,1957,2018,ACTOR IN A SUPPORTING ROLE,61,1
Richard Farnsworth,False,M,1920,1978,ACTOR IN A SUPPORTING ROLE,58,2
Richard Farnsworth,False,M,1920,1999,ACTOR IN A LEADING ROLE,79,2
Richard Harris,False,M,1930,1963,ACTOR,33,2
Richard Harris,False,M,1930,1990,ACTOR IN A LEADING ROLE,60,2
Richard Jaeckel,False,M,1926,1971,ACTOR IN A SUPPORTING ROLE,45,1
Richard Jenkins,False,M,1947,2008,ACTOR IN A LEADING ROLE,61,2
Richard Jenkins,False,M,1947,2017,ACTOR IN A SUPPORTING ROLE,70,2
Richard Todd,False,M,1919,1949,ACTOR,30,1
Richard Widmark,False,M,1914,1947,ACTOR IN A SUPPORTING ROLE,33,1
Rinko Kikuchi,False,F,1981,2006,ACTRESS IN A SUPPORTING ROLE,25,1
Rip Torn,False,M,1931,1983,ACTOR IN A SUPPORTING ROLE,52,1
Rita Moreno,True,F,1931,1961,ACTRESS IN A SUPPORTING ROLE,30,1
River Phoenix,False,M,1970,1988,ACTOR IN A SUPPORTING ROLE,18,1
Robert De Niro,False,M,1943,1976,ACTOR IN A LEADING ROLE,33,7
Robert De Niro,False,M,1943,1978,ACTOR IN A LEADING ROLE,35,7
Robert De Niro,False,M,1943,1990,ACTOR IN A LEADING ROLE,47,7
Robert De Niro,False,M,1943,1991,ACTOR IN A LEADING ROLE,48,7
Robert De Niro,False,M,1943,2012,ACTOR IN A SUPPORTING ROLE,69,7
Robert De Niro,True,M,1943,1974,ACTOR IN A SUPPORTING ROLE,31,7
Robert De Niro,True,M,1943,1980,ACTOR IN A LEADING ROLE,37,7
Robert Donat,False,M,1905,1938,ACTOR,33,2
Robert Donat,True,M,1905,1939,ACTOR,34,2
Robert Downey Jr.,False,M,1965,1992,ACTOR IN A LEADING ROLE,27,2
Robert Downey Jr.,False,M,1965,2008,ACTOR IN A SUPPORTING ROLE,43,2
Robert Duvall,False,M,1931,1972,ACTOR IN A SUPPORTING ROLE,41,7
Robert Duvall,False,M,1931,1979,ACTOR IN A SUPPORTING ROLE,48,7
Robert Duvall,False,M,1931,1980,ACTOR IN A LEADING ROLE,49,7
Robert Duvall,False,M,1931,1997,ACTOR IN A LEADING ROLE,66,7
Robert Duvall,False,M,1931,1998,ACTOR IN A SUPPORTING ROLE,67,7
Robert Duvall,False,M,1931,2014,ACTOR IN A SUPPORTING ROLE,83,7
Robert Duvall,True,M,1931,1983,ACTOR IN A LEADING ROLE,52,7
Robert Forster,False,M,1941,1997,ACTOR IN A SUPPORTING ROLE,56,1
Robert Loggia,False,M,1930,1985,ACTOR IN A SUPPORTING ROLE,55,1
Robert Mitchum,False,M,1917,1945,ACTOR IN A SUPPORTING ROLE,28,1
Robert Montgomery,False,M,1904,1937,ACTOR,33,2
Robert Montgomery,False,M,1904,1941,ACTOR,37,2
Robert Morley,False,M,1908,1938,ACTOR IN A SUPPORTING ROLE,30,1
Robert Preston,False,M,1918,1982,ACTOR IN A SUPPORTING ROLE,64,1
Robert Redford,False,M,1936,1973,ACTOR,37,1
Robert Ryan,False,M,1909,1947,ACTOR IN A SUPPORTING ROLE,38,1
Robert Shaw,False,M,1927,1966,ACTOR IN A SUPPORTING ROLE,39,1
Robert Stack,False,M,1919,1956,ACTOR IN A SUPPORTING ROLE,37,1
Robert Strauss,False,M,1913,1953,ACTOR IN A SUPPORTING ROLE,40,1
Robert Vaughn,False,M,1932,1959,ACTOR IN A SUPPORTING ROLE,27,1
Roberto Benigni,True,M,1952,1998,ACTOR IN A LEADING ROLE,46,1
Robin Williams,False,M,1951,1987,ACTOR IN A LEADING ROLE,36,4
Robin Williams,False,M,1951,1989,ACTOR IN A LEADING ROLE,38,4
Robin Williams,False,M,1951,1991,ACTOR IN A LEADING ROLE,40,4
Robin Williams,True,M,1951,1997,ACTOR IN A SUPPORTING ROLE,46,4
Rock Hudson,False,M,1925,1956,ACTOR,31,1
Rod Steiger,False,M,1925,1954,ACTOR IN A SUPPORTING ROLE,29,3
Rod Steiger,False,M,1925,1965,ACTOR,40,3
Rod Steiger,True,M,1925,1967,ACTOR,42,3
Roland Young,False,M,1887,1937,ACTOR IN A SUPPORTING ROLE,50,1
Ron Moody,False,M,1924,1968,ACTOR,44,1
Ronald Colman,False,M,1891,1929,ACTOR,38,3
Ronald Colman,False,M,1891,1942,ACTOR,51,3
Ronald Colman,True,M,1891,1947,ACTOR,56,3
Ronee Blakley,False,F,1945,1975,ACTRESS IN A SUPPORTING ROLE,30,1
Rooney Mara,False,F,1985,2011,ACTRESS IN A LEADING ROLE,26,2
Rooney Mara,False,F,1985,2015,ACTRESS IN A SUPPORTING ROLE,30,2
Rosalind Russell,False,F,1907,1942,ACTRESS,35,4
Rosalind Russell,False,F,1907,1946,ACTRESS,39,4
Rosalind Russell,False,F,1907,1947,ACTRESS,40,4
Rosalind Russell,False,F,1907,1958,ACTRESS,51,4
Rosamund Pike,False,F,1979,2014,ACTRESS IN A LEADING ROLE,35,1
Rosemary Harris,False,F,1927,1994,ACTRESS IN A SUPPORTING ROLE,67,1
Rosie Perez,False,F,1964,1993,ACTRESS IN A SUPPORTING ROLE,29,1
Roy Scheider,False,M,1932,1971,ACTOR IN A SUPPORTING ROLE,39,2
Roy Scheider,False,M,1932,1979,ACTOR IN A LEADING ROLE,47,2
Ruby Dee,False,F,1922,2007,ACTRESS IN A SUPPORTING ROLE,85,1
Rupert Crosse,False,M,1927,1969,ACTOR IN A SUPPORTING ROLE,42,1
Russ Tamblyn,False,M,1934,1957,ACTOR IN A SUPPORTING ROLE,23,1
Russell Crowe,False,M,1964,1999,ACTOR IN A LEADING ROLE,35,3
Russell Crowe,False,M,1964,2001,ACTOR IN A LEADING ROLE,37,3
Russell Crowe,True,M,1964,2000,ACTOR IN A LEADING ROLE,36,3
Ruth Chatterton,False,F,1892,1928,ACTRESS,36,2
Ruth Chatterton,False,F,1892,1929,ACTRESS,37,2
Ruth Gordon,False,F,1896,1965,ACTRESS IN A SUPPORTING ROLE,69,2
Ruth Gordon,True,F,1896,1968,ACTRESS IN A SUPPORTING ROLE,72,2
Ruth Hussey,False,F,1911,1940,ACTRESS IN A SUPPORTING ROLE,29,1
Ruth Negga,False,F,1982,2016,ACTRESS IN A LEADING ROLE,34,1
Ryan Gosling,False,M,1980,2006,ACTOR IN A LEADING ROLE,26,2
Ryan Gosling,False,M,1980,2016,ACTOR IN A LEADING ROLE,36,2
Ryan O'Neal,False,M,1941,1970,ACTOR,29,1
Sal Mineo,False,M,1939,1955,ACTOR IN A SUPPORTING ROLE,16,2
Sal Mineo,False,M,1939,1960,ACTOR IN A SUPPORTING ROLE,21,2
Sally Field,False,F,1946,2012,ACTRESS IN A SUPPORTING ROLE,66,3
Sally Field,True,F,1946,1979,ACTRESS IN A LEADING ROLE,33,3
Sally Field,True,F,1946,1984,ACTRESS IN A LEADING ROLE,38,3
Sally Hawkins,False,F,1976,2013,ACTRESS IN A SUPPORTING ROLE,37,2
Sally Hawkins,False,F,1976,2017,ACTRESS IN A LEADING ROLE,41,2
Sally Kellerman,False,F,1937,1970,ACTRESS IN A SUPPORTING ROLE,33,1
Sally Kirkland,False,F,1941,1987,ACTRESS IN A LEADING ROLE,46,1
Salma Hayek,False,F,1966,2002,ACTRESS IN A LEADING ROLE,36,1
Sam Elliott,False,M,1944,2018,ACTOR IN A SUPPORTING ROLE,74,1
Sam Jaffe,False,M,1891,1950,ACTOR IN A SUPPORTING ROLE,59,1
Sam Rockwell,False,M,1968,2018,ACTOR IN A SUPPORTING ROLE,50,2
Sam Rockwell,True,M,1968,2017,ACTOR IN A SUPPORTING ROLE,49,2
Sam Shepard,False,M,1943,1983,ACTOR IN A SUPPORTING ROLE,40,1
Sam Waterston,False,M,1940,1984,ACTOR IN A LEADING ROLE,44,1
Samantha Eggar,False,F,1939,1965,ACTRESS,26,1
Samantha Morton,False,F,1977,1999,ACTRESS IN A SUPPORTING ROLE,22,2
Samantha Morton,False,F,1977,2003,ACTRESS IN A LEADING ROLE,26,2
Samuel L. Jackson,False,M,1948,1994,ACTOR IN A SUPPORTING ROLE,46,1
Sandra Bullock,False,F,1964,2013,ACTRESS IN A LEADING ROLE,49,2
Sandra Bullock,True,F,1964,2009,ACTRESS IN A LEADING ROLE,45,2
Sandy Dennis,True,F,1937,1966,ACTRESS IN A SUPPORTING ROLE,29,1
Saoirse Ronan,False,F,1994,2007,ACTRESS IN A SUPPORTING ROLE,13,4
Saoirse Ronan,False,F,1994,2015,ACTRESS IN A LEADING ROLE,21,4
Saoirse Ronan,False,F,1994,2017,ACTRESS IN A LEADING ROLE,23,4
Saoirse Ronan,False,F,1994,2019,ACTRESS IN A LEADING ROLE,25,4
Sara Allgood,False,F,1880,1941,ACTRESS IN A SUPPORTING ROLE,61,1
Sarah Miles,False,F,1941,1970,ACTRESS,29,1
Scarlett Johansson,False,F,1984,2019,ACTRESS IN A LEADING ROLE,35,2
Scarlett Johansson,False,F,1984,2019,ACTRESS IN A SUPPORTING ROLE,35,2
Sean Connery,True,M,1930,1987,ACTOR IN A SUPPORTING ROLE,57,1
Sean Penn,False,M,1960,1995,ACTOR IN A LEADING ROLE,35,5
Sean Penn,False,M,1960,1999,ACTOR IN A LEADING ROLE,39,5
Sean Penn,False,M,1960,2001,ACTOR IN A LEADING ROLE,41,5
Sean Penn,True,M,1960,2003,ACTOR IN A LEADING ROLE,43,5
Sean Penn,True,M,1960,2008,ACTOR IN A LEADING ROLE,48,5
Sessue Hayakawa,False,M,1889,1957,ACTOR IN A SUPPORTING ROLE,68,1
Seymour Cassel,False,M,1935,1968,ACTOR IN A SUPPORTING ROLE,33,1
Sharon Stone,False,F,1958,1995,ACTRESS IN A LEADING ROLE,37,1
Shelley Winters,False,F,1920,1951,ACTRESS,31,4
Shelley Winters,False,F,1920,1972,ACTRESS IN A SUPPORTING ROLE,52,4
Shelley Winters,True,F,1920,1959,ACTRESS IN A SUPPORTING ROLE,39,4
Shelley Winters,True,F,1920,1965,ACTRESS IN A SUPPORTING ROLE,45,4
Shirley Booth,True,F,1898,1952,ACTRESS,54,1
Shirley Jones,True,F,1934,1960,ACTRESS IN A SUPPORTING ROLE,26,1
Shirley Knight,False,F,1936,1960,ACTRESS IN A SUPPORTING ROLE,24,2
Shirley Knight,False,F,1936,1962,ACTRESS IN A SUPPORTING ROLE,26,2
Shirley MacLaine,False,F,1934,1958,ACTRESS,24,5
Shirley MacLaine,False,F,1934,1960,ACTRESS,26,5
Shirley MacLaine,False,F,1934,1963,ACTRESS,29,5
Shirley MacLaine,False,F,1934,1977,ACTRESS IN A LEADING ROLE,43,5
Shirley MacLaine,True,F,1934,1983,ACTRESS IN A LEADING ROLE,49,5
Shohreh Aghdashloo,False,F,1952,2003,ACTRESS IN A SUPPORTING ROLE,51,1
Sidney Poitier,False,M,1927,1958,ACTOR,31,2
Sidney Poitier,True,M,1927,1963,ACTOR,36,2
Sigourney Weaver,False,F,1949,1986,ACTRESS IN A LEADING ROLE,37,3
Sigourney Weaver,False,F,1949,1988,ACTRESS IN A LEADING ROLE,39,3
Sigourney Weaver,False,F,1949,1988,ACTRESS IN A SUPPORTING ROLE,39,3
Simone Signoret,False,F,1921,1965,ACTRESS,44,2
Simone Signoret,True,F,1921,1959,ACTRESS,38,2
Sissy Spacek,False,F,1949,1976,ACTRESS IN A LEADING ROLE,27,6
Sissy Spacek,False,F,1949,1982,ACTRESS IN A LEADING ROLE,33,6
Sissy Spacek,False,F,1949,1984,ACTRESS IN A LEADING ROLE,35,6
Sissy Spacek,False,F,1949,1986,ACTRESS IN A LEADING ROLE,37,6
Sissy Spacek,False,F,1949,2001,ACTRESS IN A LEADING ROLE,52,6
Sissy Spacek,True,F,1949,1980,ACTRESS IN A LEADING ROLE,31,6
Sondra Locke,False,F,1944,1968,ACTRESS IN A SUPPORTING ROLE,24,1
Sophia Loren,False,F,1934,1964,ACTRESS,30,2
Sophia Loren,True,F,1934,1961,ACTRESS,27,2
Sophie Okonedo,False,F,1968,2004,ACTRESS IN A SUPPORTING ROLE,36,1
Spencer Tracy,False,M,1900,1936,ACTOR,36,9
Spencer Tracy,False,M,1900,1950,ACTOR,50,9
Spencer Tracy,False,M,1900,1955,ACTOR,55,9
Spencer Tracy,False,M,1900,1958,ACTOR,58,9
Spencer Tracy,False,M,1900,1960,ACTOR,60,9
Spencer Tracy,False,M,1900,1961,ACTOR,61,9
Spencer Tracy,False,M,1900,1967,ACTOR,67,9
Spencer Tracy,True,M,1900,1937,ACTOR,37,9
Spencer Tracy,True,M,1900,1938,ACTOR,38,9
Spring Byington,False,F,1886,1938,ACTRESS IN A SUPPORTING ROLE,52,1
Stanley Holloway,False,M,1890,1964,ACTOR IN A SUPPORTING ROLE,74,1
Stanley Tucci,False,M,1960,2009,ACTOR IN A SUPPORTING ROLE,49,1
Stephen Rea,False,M,1946,1992,ACTOR IN A LEADING ROLE,46,1
Steve Carell,False,M,1962,2014,ACTOR IN A LEADING ROLE,52,1
Steve McQueen,False,M,1930,1966,ACTOR,36,1
Stockard Channing,False,F,1944,1993,ACTRESS IN A LEADING ROLE,49,1
Stuart Erwin,False,M,1903,1936,ACTOR IN A SUPPORTING ROLE,33,1
Stuart Whitman,False,M,1928,1961,ACTOR,33,1
Susan Hayward,False,F,1917,1947,ACTRESS,30,5
Susan Hayward,False,F,1917,1949,ACTRESS,32,5
Susan Hayward,False,F,1917,1952,ACTRESS,35,5
Susan Hayward,False,F,1917,1955,ACTRESS,38,5
Susan Hayward,True,F,1917,1958,ACTRESS,41,5
Susan Kohner,False,F,1936,1959,ACTRESS IN A SUPPORTING ROLE,23,1
Susan Peters,False,F,1921,1942,ACTRESS IN A SUPPORTING ROLE,21,1
Susan Sarandon,False,F,1946,1981,ACTRESS IN A LEADING ROLE,35,5
Susan Sarandon,False,F,1946,1991,ACTRESS IN A LEADING ROLE,45,5
Susan Sarandon,False,F,1946,1992,ACTRESS IN A LEADING ROLE,46,5
Susan Sarandon,False,F,1946,1994,ACTRESS IN A LEADING ROLE,48,5
Susan Sarandon,True,F,1946,1995,ACTRESS IN A LEADING ROLE,49,5
Susan Tyrrell,False,F,1945,1972,ACTRESS IN A SUPPORTING ROLE,27,1
Susannah York,False,F,1939,1969,ACTRESS IN A SUPPORTING ROLE,30,1
Sydney Greenstreet,False,M,1879,1941,ACTOR IN A SUPPORTING ROLE,62,1
Sylvester Stallone,False,M,1946,1976,ACTOR IN A LEADING ROLE,30,2
Sylvester Stallone,False,M,1946,2015,ACTOR IN A SUPPORTING ROLE,69,2
Sylvia Miles,False,F,1924,1969,ACTRESS IN A SUPPORTING ROLE,45,2
Sylvia Miles,False,F,1924,1975,ACTRESS IN A SUPPORTING ROLE,51,2
Sylvia Sidney,False,F,1910,1973,ACTRESS IN A SUPPORTING ROLE,63,1
Talia Shire,False,F,1946,1974,ACTRESS IN A SUPPORTING ROLE,28,2
Talia Shire,False,F,1946,1976,ACTRESS IN A LEADING ROLE,30,2
Taraji P. Henson,False,F,1970,2008,ACTRESS IN A SUPPORTING ROLE,38,1
Tatum O'Neal,True,F,1963,1973,ACTRESS IN A SUPPORTING ROLE,10,1
Telly Savalas,False,M,1922,1962,ACTOR IN A SUPPORTING ROLE,40,1
Terence Stamp,False,M,1938,1962,ACTOR IN A SUPPORTING ROLE,24,1
Teresa Wright,False,F,1918,1941,ACTRESS IN A SUPPORTING ROLE,23,3
Teresa Wright,False,F,1918,1942,ACTRESS,24,3
Teresa Wright,True,F,1918,1942,ACTRESS IN A SUPPORTING ROLE,24,3
Teri Garr,False,F,1947,1982,ACTRESS IN A SUPPORTING ROLE,35,1
Terrence Howard,False,M,1969,2005,ACTOR IN A LEADING ROLE,36,1
Terry Moore,False,F,1929,1952,ACTRESS IN A SUPPORTING ROLE,23,1
Tess Harper,False,F,1950,1986,ACTRESS IN A SUPPORTING ROLE,36,1
Thelma Ritter,False,F,1902,1950,ACTRESS IN A SUPPORTING ROLE,48,6
Thelma Ritter,False,F,1902,1951,ACTRESS IN A SUPPORTING ROLE,49,6
Thelma Ritter,False,F,1902,1952,ACTRESS IN A SUPPORTING ROLE,50,6
Thelma Ritter,False,F,1902,1953,ACTRESS IN A SUPPORTING ROLE,51,6
Thelma Ritter,False,F,1902,1959,ACTRESS IN A SUPPORTING ROLE,57,6
Thelma Ritter,False,F,1902,1962,ACTRESS IN A SUPPORTING ROLE,60,6
Theodore Bikel,False,M,1924,1958,ACTOR IN A SUPPORTING ROLE,34,1
Thomas Gomez,False,M,1905,1947,ACTOR IN A SUPPORTING ROLE,42,1
Thomas Haden Church,False,M,1960,2004,ACTOR IN A SUPPORTING ROLE,44,1
Thomas Mitchell,False,M,1892,1937,ACTOR IN A SUPPORTING ROLE,45,2
Thomas Mitchell,True,M,1892,1939,ACTOR IN A SUPPORTING ROLE,47,2
Tilda Swinton,True,F,1960,2007,ACTRESS IN A SUPPORTING ROLE,47,1
Tim Robbins,True,M,1958,2003,ACTOR IN A SUPPORTING ROLE,45,1
Tim Roth,False,M,1961,1995,ACTOR IN A SUPPORTING ROLE,34,1
Timothy Hutton,True,M,1960,1980,ACTOR IN A SUPPORTING ROLE,20,1
Timothée Chalamet,False,M,1995,2017,ACTOR IN A LEADING ROLE,22,1
Tom Berenger,False,M,1949,1986,ACTOR IN A SUPPORTING ROLE,37,1
Tom Conti,False,M,1941,1983,ACTOR IN A LEADING ROLE,42,1
Tom Courtenay,False,M,1937,1965,ACTOR IN A SUPPORTING ROLE,28,2
Tom Courtenay,False,M,1937,1983,ACTOR IN A LEADING ROLE,46,2
Tom Cruise,False,M,1962,1989,ACTOR IN A LEADING ROLE,27,3
Tom Cruise,False,M,1962,1996,ACTOR IN A LEADING ROLE,34,3
Tom Cruise,False,M,1962,1999,ACTOR IN A SUPPORTING ROLE,37,3
Tom Hanks,False,M,1956,1988,ACTOR IN A LEADING ROLE,32,6
Tom Hanks,False,M,1956,1998,ACTOR IN A LEADING ROLE,42,6
Tom Hanks,False,M,1956,2000,ACTOR IN A LEADING ROLE,44,6
Tom Hanks,False,M,1956,2019,ACTOR IN A SUPPORTING ROLE,63,6
Tom Hanks,True,M,1956,1993,ACTOR IN A LEADING ROLE,37,6
Tom Hanks,True,M,1956,1994,ACTOR IN A LEADING ROLE,38,6
Tom Hardy,False,M,1977,2015,ACTOR IN A SUPPORTING ROLE,38,1
Tom Hulce,False,M,1953,1984,ACTOR IN A LEADING ROLE,31,1
Tom Tully,False,M,1908,1954,ACTOR IN A SUPPORTING ROLE,46,1
Tom Wilkinson,False,M,1948,2001,ACTOR IN A LEADING ROLE,53,2
Tom Wilkinson,False,M,1948,2007,ACTOR IN A SUPPORTING ROLE,59,2
Tommy Lee Jones,False,M,1946,1991,ACTOR IN A SUPPORTING ROLE,45,4
Tommy Lee Jones,False,M,1946,2007,ACTOR IN A LEADING ROLE,61,4
Tommy Lee Jones,False,M,1946,2012,ACTOR IN A SUPPORTING ROLE,66,4
Tommy Lee Jones,True,M,1946,1993,ACTOR IN A SUPPORTING ROLE,47,4
Toni Collette,False,F,1972,1999,ACTRESS IN A SUPPORTING ROLE,27,1
Tony Curtis,False,M,1925,1958,ACTOR,33,1
Topol,False,M,1935,1971,ACTOR,36,1
Trevor Howard,False,M,1913,1960,ACTOR,47,1
Tuesday Weld,False,F,1943,1977,ACTRESS IN A SUPPORTING ROLE,34,1
Uma Thurman,False,F,1970,1994,ACTRESS IN A SUPPORTING ROLE,24,1
Una Merkel,False,F,1903,1961,ACTRESS IN A SUPPORTING ROLE,58,1
Valentina Cortese,False,F,1923,1974,ACTRESS IN A SUPPORTING ROLE,51,1
Valerie Perrine,False,F,1943,1974,ACTRESS,31,1
Van Heflin,True,M,1908,1942,ACTOR IN A SUPPORTING ROLE,34,1
Vanessa Redgrave,False,F,1937,1966,ACTRESS,29,6
Vanessa Redgrave,False,F,1937,1968,ACTRESS,31,6
Vanessa Redgrave,False,F,1937,1971,ACTRESS,34,6
Vanessa Redgrave,False,F,1937,1984,ACTRESS IN A LEADING ROLE,47,6
Vanessa Redgrave,False,F,1937,1992,ACTRESS IN A SUPPORTING ROLE,55,6
Vanessa Redgrave,True,F,1937,1977,ACTRESS IN A SUPPORTING ROLE,40,6
Vera Farmiga,False,F,1973,2009,ACTRESS IN A SUPPORTING ROLE,36,1
Victor Buono,False,M,1938,1962,ACTOR IN A SUPPORTING ROLE,24,1
Victor McLaglen,False,M,1886,1952,ACTOR IN A SUPPORTING ROLE,66,2
Victor McLaglen,True,M,1886,1935,ACTOR,49,2
Viggo Mortensen,False,M,1958,2007,ACTOR IN A LEADING ROLE,49,3
Viggo Mortensen,False,M,1958,2016,ACTOR IN A LEADING ROLE,58,3
Viggo Mortensen,False,M,1958,2018,ACTOR IN A LEADING ROLE,60,3
Vincent Gardenia,False,M,1920,1973,ACTOR IN A SUPPORTING ROLE,53,2
Vincent Gardenia,False,M,1920,1987,ACTOR IN A SUPPORTING ROLE,67,2
Viola Davis,False,F,1965,2008,ACTRESS IN A SUPPORTING ROLE,43,3
Viola Davis,False,F,1965,2011,ACTRESS IN A LEADING ROLE,46,3
Viola Davis,True,F,1965,2016,ACTRESS IN A SUPPORTING ROLE,51,3
Virginia Madsen,False,F,1961,2004,ACTRESS IN A SUPPORTING ROLE,43,1
Vittorio De Sica,False,M,1901,1957,ACTOR IN A SUPPORTING ROLE,56,1
Vivien Leigh,True,F,1913,1939,ACTRESS,26,2
Vivien Leigh,True,F,1913,1951,ACTRESS,38,2
Vivien Merchant,False,F,1929,1966,ACTRESS IN A SUPPORTING ROLE,37,1
Wallace Beery,False,M,1885,1929,ACTOR,44,2
Wallace Beery,True,M,1885,1931,ACTOR,46,2
Walter Brennan,False,M,1894,1941,ACTOR IN A SUPPORTING ROLE,47,4
Walter Brennan,True,M,1894,1936,ACTOR IN A SUPPORTING ROLE,42,4
Walter Brennan,True,M,1894,1938,ACTOR IN A SUPPORTING ROLE,44,4
Walter Brennan,True,M,1894,1940,ACTOR IN A SUPPORTING ROLE,46,4
Walter Huston,False,M,1883,1936,ACTOR,53,4
Walter Huston,False,M,1883,1941,ACTOR,58,4
Walter Huston,False,M,1883,1942,ACTOR IN A SUPPORTING ROLE,59,4
Walter Huston,True,M,1883,1948,ACTOR IN A SUPPORTING ROLE,65,4
Walter Matthau,False,M,1920,1971,ACTOR,51,3
Walter Matthau,False,M,1920,1975,ACTOR,55,3
Walter Matthau,True,M,1920,1966,ACTOR IN A SUPPORTING ROLE,46,3
Walter Pidgeon,False,M,1897,1942,ACTOR,45,2
Walter Pidgeon,False,M,1897,1943,ACTOR,46,2
Warner Baxter,True,M,1889,1928,ACTOR,39,1
Warren Beatty,False,M,1937,1967,ACTOR,30,4
Warren Beatty,False,M,1937,1978,ACTOR IN A LEADING ROLE,41,4
Warren Beatty,False,M,1937,1981,ACTOR IN A LEADING ROLE,44,4
Warren Beatty,False,M,1937,1991,ACTOR IN A LEADING ROLE,54,4
Wendy Hiller,False,F,1912,1938,ACTRESS,26,3
Wendy Hiller,False,F,1912,1966,ACTRESS IN A SUPPORTING ROLE,54,3
Wendy Hiller,True,F,1912,1958,ACTRESS IN A SUPPORTING ROLE,46,3
Whoopi Goldberg,False,F,1955,1985,ACTRESS IN A LEADING ROLE,30,2
Whoopi Goldberg,True,F,1955,1990,ACTRESS IN A SUPPORTING ROLE,35,2
Will Smith,False,M,1968,2001,ACTOR IN A LEADING ROLE,33,2
Will Smith,False,M,1968,2006,ACTOR IN A LEADING ROLE,38,2
Willem Dafoe,False,M,1955,1986,ACTOR IN A SUPPORTING ROLE,31,4
Willem Dafoe,False,M,1955,2000,ACTOR IN A SUPPORTING ROLE,45,4
Willem Dafoe,False,M,1955,2017,ACTOR IN A SUPPORTING ROLE,62,4
Willem Dafoe,False,M,1955,2018,ACTOR IN A LEADING ROLE,63,4
William Bendix,False,M,1906,1942,ACTOR IN A SUPPORTING ROLE,36,1
William Demarest,False,M,1892,1946,ACTOR IN A SUPPORTING ROLE,54,1
William Gargan,False,M,1905,1940,ACTOR IN A SUPPORTING ROLE,35,1
William H. Macy,False,M,1950,1996,ACTOR IN A SUPPORTING ROLE,46,1
William Hickey,False,M,1927,1985,ACTOR IN A SUPPORTING ROLE,58,1
William Holden,False,M,1918,1950,ACTOR,32,3
William Holden,False,M,1918,1976,ACTOR IN A LEADING ROLE,58,3
William Holden,True,M,1918,1953,ACTOR,35,3
William Hurt,False,M,1950,1986,ACTOR IN A LEADING ROLE,36,4
William Hurt,False,M,1950,1987,ACTOR IN A LEADING ROLE,37,4
William Hurt,False,M,1950,2005,ACTOR IN A SUPPORTING ROLE,55,4
William Hurt,True,M,1950,1985,ACTOR IN A LEADING ROLE,35,4
William Powell,False,M,1892,1934,ACTOR,42,3
William Powell,False,M,1892,1936,ACTOR,44,3
William Powell,False,M,1892,1947,ACTOR,55,3
Winona Ryder,False,F,1971,1993,ACTRESS IN A SUPPORTING ROLE,22,2
Winona Ryder,False,F,1971,1994,ACTRESS IN A LEADING ROLE,23,2
Woody Allen,False,M,1935,1977,ACTOR IN A LEADING ROLE,42,1
Woody Harrelson,False,M,1961,1996,ACTOR IN A LEADING ROLE,35,3
Woody Harrelson,False,M,1961,2009,ACTOR IN A SUPPORTING ROLE,48,3
Woody Harrelson,False,M,1961,2017,ACTOR IN A SUPPORTING ROLE,56,3
Yalitza Aparicio,False,F,1993,2018,ACTRESS IN A LEADING ROLE,25,1
Yul Brynner,True,M,1920,1956,ACTOR,36,1
